Date,Kind,Model,Max Mode,Input (w/ Cache Write),Input (w/o Cache Write),Cache Read,Output Tokens,Total Tokens,Cost
"2025-09-04T19:20:30.710Z","pro-free-trial","auto","No","522","0","62185","265","62972","Included"
"2025-09-04T19:19:15.179Z","pro-free-trial","auto","No","6506","0","292650","1708","300864","Included"
"2025-09-04T19:14:23.098Z","pro-free-trial","auto","No","43190","0","1548371","4797","1596358","Included"
"2025-09-04T19:12:43.923Z","pro-free-trial","auto","No","95033","0","4781492","7864","4884389","Included"
"2025-09-04T19:07:02.010Z","pro-free-trial","auto","No","62060","0","2014470","9143","2085673","Included"
"2025-09-04T19:06:51.893Z","Errored, Not Charged","auto","No","51811","0","1325302","5760","1382873","Included"
"2025-09-04T19:06:12.310Z","pro-free-trial","auto","No","40026","0","187618","1563","229207","Included"
"2025-09-04T19:04:28.020Z","pro-free-trial","auto","No","45610","0","445289","831","491730","Included"
"2025-09-04T18:53:21.935Z","pro-free-trial","auto","No","64128","0","2996812","11979","3072919","Included"
"2025-09-04T18:48:44.942Z","pro-free-trial","auto","No","183","0","91406","598","92187","Included"
"2025-09-04T18:48:09.164Z","Errored, Not Charged","auto","No","92","0","91179","57","91328","Included"
"2025-09-04T18:47:39.483Z","Errored, Not Charged","auto","No","186","0","90842","73","91101","Included"
"2025-09-04T18:46:02.760Z","pro-free-trial","auto","No","383","0","181000","57","181440","Included"
"2025-09-04T18:45:53.180Z","pro-free-trial","auto","No","0","0","0","0","0","Included"
"2025-09-04T18:45:44.815Z","Errored, Not Charged","auto","No","75580","0","14997","56","90633","Included"
"2025-09-04T18:42:20.133Z","Errored, Not Charged","auto","No","95206","0","1647513","2606","1745325","Included"
"2025-09-04T18:41:53.711Z","pro-free-trial","auto","No","5886","0","155927","477","162290","Included"
"2025-09-04T18:41:47.345Z","Errored, Not Charged","auto","No","61936","0","15877","63","77876","Included"
"2025-09-04T18:34:46.128Z","pro-free-trial","auto","No","6250","0","79993","481","86724","Included"
"2025-09-04T18:34:34.944Z","Errored, Not Charged","auto","No","17702","0","2544020","3177","2564899","Included"
"2025-09-04T18:33:02.186Z","pro-free-trial","auto","No","45892","83197","136822","4453","270364","Included"
"2025-09-04T18:32:06.062Z","pro-free-trial","auto","No","6321","0","32852","274","39447","Included"
"2025-09-04T18:31:09.661Z","Errored, Not Charged","auto","No","62807","0","15864","218","78889","Included"
"2025-09-04T18:29:49.035Z","pro-free-trial","auto","No","10160","0","383136","1772","395068","Included"
"2025-09-04T18:26:22.273Z","pro-free-trial","auto","No","61604","69050","1019726","8176","1158556","Included"
"2025-09-04T18:22:58.185Z","pro-free-trial","auto","No","92092","0","3387885","6479","3486456","Included"
"2025-09-04T18:18:55.311Z","pro-free-trial","auto","No","42153","0","1023094","2889","1068136","Included"
"2025-09-04T18:15:07.087Z","pro-free-trial","auto","No","4959","0","227554","1305","233818","Included"
"2025-09-04T18:14:52.586Z","pro-free-trial","auto","No","63626","0","2122410","5080","2191116","Included"
"2025-09-04T18:11:21.049Z","Errored, Not Charged","auto","No","23602","0","1307748","6235","1337585","Included"
"2025-09-04T18:10:55.648Z","Errored, Not Charged","auto","No","75539","0","7620048","21028","7716615","Included"
"2025-09-04T18:10:25.249Z","pro-free-trial","auto","No","28167","0","897219","3949","929335","Included"
"2025-09-04T18:10:14.427Z","pro-free-trial","auto","No","6186","0","242371","1283","249840","Included"
"2025-09-04T18:09:35.552Z","Errored, Not Charged","auto","No","247","0","15860","212","16319","Included"
"2025-09-04T18:09:05.559Z","Errored, Not Charged","auto","No","24159","0","177721","832","202712","Included"
"2025-09-04T18:00:06.732Z","pro-free-trial","auto","No","2389","0","203195","827","206411","Included"
"2025-09-04T17:57:58.438Z","pro-free-trial","auto","No","5792","0","765297","1229","772318","Included"
"2025-09-04T17:57:36.856Z","Errored, Not Charged","auto","No","1260","0","179398","980","181638","Included"
"2025-09-04T17:56:18.682Z","pro-free-trial","auto","No","4968","0","673942","2295","681205","Included"
"2025-09-04T17:53:36.079Z","pro-free-trial","auto","No","5894","0","666030","1623","673547","Included"
"2025-09-04T17:53:17.433Z","pro-free-trial","auto","No","38735","0","524082","8483","571300","Included"
"2025-09-04T17:49:15.565Z","pro-free-trial","auto","No","8792","0","309385","1175","319352","Included"
"2025-09-04T17:48:42.430Z","pro-free-trial","auto","No","37385","0","1342246","4395","1384026","Included"
"2025-09-04T17:45:14.100Z","pro-free-trial","auto","No","7771","1126","850429","3266","862592","Included"
"2025-09-04T17:44:38.971Z","pro-free-trial","auto","No","5363","0","274956","1339","281658","Included"
"2025-09-04T17:43:59.177Z","Errored, Not Charged","auto","No","17494","0","42436","325","60255","Included"
"2025-09-04T17:37:08.916Z","pro-free-trial","auto","No","1616","0","175086","1622","178324","Included"
"2025-09-04T17:36:13.155Z","pro-free-trial","auto","No","14481","0","143895","2741","161117","Included"
"2025-09-04T17:31:14.842Z","pro-free-trial","auto","No","71784","0","916627","2496","990907","Included"
"2025-09-04T17:30:57.746Z","pro-free-trial","auto","No","43602","0","538426","2456","584484","Included"
"2025-09-04T17:01:26.606Z","pro-free-trial","auto","No","6664","0","468399","2812","477875","Included"
"2025-09-04T17:00:17.705Z","pro-free-trial","auto","No","28102","0","99945","1022","129069","Included"
"2025-09-04T16:59:15.924Z","pro-free-trial","auto","No","86181","1191","1611992","3772","1703136","Included"
"2025-09-04T16:57:37.173Z","pro-free-trial","auto","No","11048","0","716665","2612","730325","Included"
"2025-09-04T16:55:53.862Z","pro-free-trial","auto","No","9169","0","599202","1977","610348","Included"
"2025-09-04T16:54:58.410Z","pro-free-trial","auto","No","4205","0","145859","1181","151245","Included"
"2025-09-04T16:54:12.801Z","pro-free-trial","auto","No","23222","0","92218","552","115992","Included"
"2025-09-04T16:53:17.098Z","pro-free-trial","auto","No","12604","0","321258","1422","335284","Included"
"2025-09-04T16:48:26.168Z","pro-free-trial","auto","No","17502","0","737211","3743","758456","Included"
"2025-09-04T16:48:18.298Z","pro-free-trial","auto","No","65769","135","3033685","7548","3107137","Included"
"2025-09-04T16:45:43.840Z","pro-free-trial","auto","No","21920","0","644253","2534","668707","Included"
"2025-09-04T16:40:37.369Z","pro-free-trial","auto","No","7901","0","316349","2750","327000","Included"
"2025-09-04T16:40:18.054Z","pro-free-trial","auto","No","49078","0","1122090","6362","1177530","Included"
"2025-09-04T14:52:59.272Z","pro-free-trial","auto","No","2510","0","142608","627","145745","Included"
"2025-09-04T14:50:55.966Z","pro-free-trial","auto","No","20264","0","439628","3248","463140","Included"
"2025-09-04T13:43:47.958Z","pro-free-trial","auto","No","2163","0","173313","516","175992","Included"
"2025-09-04T13:43:40.738Z","Errored, Not Charged","auto","No","1524","0","32229","57","33810","Included"
"2025-09-04T13:43:11.466Z","pro-free-trial","auto","No","0","0","0","0","0","Included"
"2025-09-04T13:42:51.190Z","Errored, Not Charged","auto","No","4422","0","160237","283","164942","Included"
"2025-09-04T13:42:08.273Z","Errored, Not Charged","auto","No","15761","0","291417","584","307762","Included"
"2025-09-04T13:40:59.718Z","pro-free-trial","auto","No","11995","0","840156","1103","853254","Included"
"2025-09-04T13:39:08.630Z","Errored, Not Charged","auto","No","85649","0","1529213","2871","1617733","Included"
"2025-09-04T13:36:22.496Z","pro-free-trial","auto","No","4035","0","367382","841","372258","Included"
"2025-09-04T13:35:24.021Z","pro-free-trial","auto","No","1925","0","775172","583","777680","Included"
"2025-09-04T13:34:58.228Z","pro-free-trial","auto","No","95788","0","3243063","2265","3341116","Included"
"2025-09-04T13:33:44.641Z","pro-free-trial","auto","No","28185","0","713090","5142","746417","Included"
"2025-09-04T13:33:21.518Z","pro-free-trial","auto","No","31159","0","1033145","10162","1074466","Included"
"2025-09-04T13:32:46.147Z","Errored, Not Charged","auto","No","14045","0","317230","774","332049","Included"
"2025-09-04T13:30:02.891Z","pro-free-trial","auto","No","80083","0","2079436","7189","2166708","Included"
"2025-09-04T13:29:59.389Z","pro-free-trial","auto","No","1072","0","126119","1415","128606","Included"
"2025-09-04T13:28:01.705Z","pro-free-trial","auto","No","47726","0","370565","1433","419724","Included"
"2025-09-04T13:26:03.244Z","pro-free-trial","auto","No","177342","51","6205144","8462","6390999","Included"
"2025-09-04T13:24:57.019Z","pro-free-trial","auto","No","1392","0","89826","233","91451","Included"
"2025-09-04T13:21:19.858Z","Errored, Not Charged","auto","No","39281","0","1379457","5170","1423908","Included"
"2025-09-04T13:21:13.048Z","pro-free-trial","auto","No","27175","0","887700","2330","917205","Included"
"2025-09-04T13:21:01.865Z","Errored, Not Charged","auto","No","36869","0","2318178","15377","2370424","Included"
"2025-09-04T13:20:06.767Z","pro-free-trial","auto","No","57436","0","3005420","9454","3072310","Included"
"2025-09-04T13:19:17.819Z","Errored, Not Charged","auto","No","15705","0","24934","244","40883","Included"
"2025-09-04T12:59:58.942Z","pro-free-trial","auto","No","32469","0","258152","3642","294263","Included"
"2025-09-04T12:55:09.009Z","pro-free-trial","auto","No","28903","0","441183","1746","471832","Included"
"2025-09-04T12:52:23.529Z","pro-free-trial","auto","No","53917","0","898028","3431","955376","Included"
"2025-09-04T12:47:58.230Z","Errored, Not Charged","auto","No","39397","0","9124","515","49036","Included"
"2025-09-04T12:43:40.013Z","pro-free-trial","auto","No","132629","0","1225489","4912","1363030","Included"
"2025-09-04T12:38:55.101Z","pro-free-trial","auto","No","47694","0","208465","2613","258772","Included"
"2025-09-04T12:38:13.539Z","pro-free-trial","auto","No","11106","0","253791","1776","266673","Included"
"2025-09-04T12:37:21.309Z","pro-free-trial","auto","No","4522","0","252865","1404","258791","Included"
"2025-09-04T12:34:25.641Z","pro-free-trial","auto","No","25331","0","491821","1070","518222","Included"
"2025-09-04T12:31:35.081Z","pro-free-trial","auto","No","9224","0","550298","3321","562843","Included"
"2025-09-04T12:29:57.214Z","pro-free-trial","auto","No","5279","0","668794","681","674754","Included"
"2025-09-04T12:29:44.141Z","Errored, Not Charged","auto","No","927","0","214221","217","215365","Included"
"2025-09-04T12:26:40.194Z","pro-free-trial","auto","No","5507","0","395027","1025","401559","Included"
"2025-09-04T12:26:16.619Z","Errored, Not Charged","auto","No","10975","0","219823","526","231324","Included"
"2025-09-04T12:25:36.851Z","Errored, Not Charged","auto","No","570","0","103261","261","104092","Included"
"2025-09-04T12:25:21.082Z","Errored, Not Charged","auto","No","6560","0","135219","468","142247","Included"
"2025-09-04T12:24:13.276Z","Errored, Not Charged","auto","No","487","0","43991","96","44574","Included"
"2025-09-04T12:23:34.337Z","pro-free-trial","auto","No","5530","0","367656","1372","374558","Included"
"2025-09-04T12:17:17.526Z","Errored, Not Charged","auto","No","24162","0","648840","5599","678601","Included"
"2025-09-04T12:15:23.066Z","Errored, Not Charged","auto","No","1853","0","106316","424","108593","Included"
"2025-09-04T12:15:02.077Z","pro-free-trial","auto","No","17750","0","330061","2673","350484","Included"
"2025-09-04T12:13:43.603Z","Errored, Not Charged","auto","No","1676","0","99560","132","101368","Included"
"2025-09-04T12:12:40.373Z","Errored, Not Charged","auto","No","0","89486","0","11978","101464","Included"
"2025-09-04T12:11:10.563Z","pro-free-trial","auto","No","23372","0","336744","5570","365686","Included"
"2025-09-04T12:09:56.675Z","Errored, Not Charged","auto","No","16054","0","148850","1739","166643","Included"
"2025-09-04T12:07:39.607Z","Errored, Not Charged","auto","No","42382","0","1321785","1468","1365635","Included"
"2025-09-04T11:56:30.333Z","Errored, Not Charged","auto","No","105161","61461","3942119","12515","4121256","Included"
"2025-09-04T11:51:20.208Z","Errored, Not Charged","auto","No","32652","0","3395535","6949","3435136","Included"
"2025-09-04T11:51:15.037Z","pro-free-trial","auto","No","0","0","0","0","0","Included"
"2025-09-04T11:51:03.607Z","pro-free-trial","auto","No","21389","0","112181","186","133756","Included"
"2025-09-04T11:48:22.214Z","Errored, Not Charged","auto","No","63690","0","925496","4292","993478","Included"
"2025-09-04T11:39:25.452Z","Errored, Not Charged","auto","No","36757","421","222641","3863","263682","Included"
"2025-09-04T11:08:13.142Z","pro-free-trial","auto","No","5795","0","511852","2342","519989","Included"
"2025-09-04T11:06:42.857Z","pro-free-trial","auto","No","4889","0","317905","1543","324337","Included"
"2025-09-04T11:06:13.594Z","pro-free-trial","auto","No","629","0","75168","475","76272","Included"
"2025-09-04T11:05:38.363Z","pro-free-trial","auto","No","937","0","110376","439","111752","Included"
"2025-09-04T11:01:22.889Z","Errored, Not Charged","auto","No","26446","0","497185","2964","526595","Included"
"2025-09-04T11:01:11.356Z","pro-free-trial","auto","No","23754","0","126553","2122","152429","Included"
"2025-09-04T10:38:59.706Z","Errored, Not Charged","auto","No","13465","0","361269","1708","376442","Included"
"2025-09-04T10:37:31.252Z","pro-free-trial","auto","No","6895","0","122560","400","129855","Included"
"2025-09-04T10:37:18.016Z","Errored, Not Charged","auto","No","16059","0","263565","4707","284331","Included"
"2025-09-04T10:36:59.811Z","Errored, Not Charged","auto","No","5522","0","76059","628","82209","Included"
"2025-09-04T10:10:01.337Z","Errored, Not Charged","auto","No","4442","0","346664","1022","352128","Included"
"2025-09-04T10:06:38.354Z","Errored, Not Charged","auto","No","11176","0","493847","2106","507129","Included"
"2025-09-04T10:05:58.403Z","Errored, Not Charged","auto","No","39824","0","12973","101","52898","Included"
"2025-09-04T10:02:14.881Z","Errored, Not Charged","auto","No","36900","0","529221","718","566839","Included"
"2025-09-04T10:01:17.829Z","pro-free-trial","auto","No","32376","0","67237","149","99762","Included"
"2025-09-04T09:54:49.297Z","pro-free-trial","auto","No","29894","0","737425","5698","773017","Included"
"2025-09-04T09:42:47.799Z","Errored, Not Charged","auto","No","4872","0","130151","1335","136358","Included"
"2025-09-04T09:42:28.107Z","Errored, Not Charged","auto","No","15016","0","42832","425","58273","Included"
"2025-09-04T09:23:44.698Z","pro-free-trial","auto","No","4561","0","411288","1905","417754","Included"
"2025-09-04T09:22:54.822Z","pro-free-trial","auto","No","12118","0","297301","936","310355","Included"
"2025-09-04T09:21:19.730Z","pro-free-trial","auto","No","14352","0","267800","1542","283694","Included"
"2025-09-04T09:20:46.374Z","pro-free-trial","auto","No","1855","0","122242","337","124434","Included"
"2025-09-04T09:20:29.346Z","pro-free-trial","auto","No","1349","0","157275","577","159201","Included"
"2025-09-04T09:20:15.655Z","Errored, Not Charged","auto","No","545","0","38300","0","38845","Included"
"2025-09-04T09:18:22.330Z","Errored, Not Charged","auto","No","31093","0","602982","3954","638029","Included"
"2025-09-04T07:24:14.862Z","Errored, Not Charged","auto","No","23393","0","322985","1030","347408","Included"
"2025-09-04T06:20:23.907Z","pro-free-trial","auto","No","2614","0","250710","412","253736","Included"
"2025-09-04T06:16:46.889Z","Errored, Not Charged","auto","No","5655","0","333994","1739","341388","Included"
"2025-09-04T06:02:14.889Z","pro-free-trial","auto","No","17635","0","293044","1438","312117","Included"
"2025-09-04T05:59:38.894Z","pro-free-trial","auto","No","28034","0","964887","5268","998189","Included"
"2025-09-04T05:56:23.008Z","pro-free-trial","auto","No","11043","0","303824","1650","316517","Included"
"2025-09-04T05:51:02.499Z","pro-free-trial","auto","No","2588","0","170510","396","173494","Included"
"2025-09-04T05:50:33.768Z","pro-free-trial","auto","No","2855","0","223800","674","227329","Included"
"2025-09-04T05:49:30.093Z","Errored, Not Charged","auto","No","5663","0","158766","491","164920","Included"
"2025-09-04T05:48:41.706Z","pro-free-trial","auto","No","2653","0","240684","732","244069","Included"
"2025-09-04T05:47:39.328Z","pro-free-trial","auto","No","4238","0","359525","790","364553","Included"
"2025-09-04T05:46:01.071Z","pro-free-trial","auto","No","1734","0","83010","245","84989","Included"
"2025-09-04T05:45:01.360Z","pro-free-trial","auto","No","33968","0","395152","1660","430780","Included"
"2025-09-04T05:43:14.191Z","pro-free-trial","auto","No","3808","0","169479","722","174009","Included"
"2025-09-04T05:42:51.856Z","Errored, Not Charged","auto","No","2949","0","88172","938","92059","Included"
"2025-09-04T05:37:27.478Z","pro-free-trial","auto","No","2740","0","106332","1067","110139","Included"
"2025-09-04T05:36:57.947Z","pro-free-trial","auto","No","3870","0","142648","1152","147670","Included"
"2025-09-04T05:35:57.911Z","pro-free-trial","auto","No","14607","0","28888","96","43591","Included"
"2025-09-04T05:35:12.406Z","pro-free-trial","auto","No","2931","0","107191","609","110731","Included"
"2025-09-04T05:34:39.460Z","pro-free-trial","auto","No","14486","0","62140","424","77050","Included"
"2025-09-04T04:59:32.851Z","pro-free-trial","auto","No","8856","0","7228","159","16243","Included"
"2025-09-04T04:31:15.410Z","pro-free-trial","auto","No","9798","0","39446","523","49767","Included"
"2025-09-04T03:05:46.146Z","Errored, Not Charged","auto","No","34395","0","206223","491","241109","Included"
"2025-09-04T02:06:20.157Z","pro-free-trial","auto","No","2391","0","170565","752","173708","Included"
"2025-09-04T01:58:21.896Z","pro-free-trial","auto","No","7812","0","371689","4346","383847","Included"
"2025-09-04T01:53:06.343Z","Errored, Not Charged","auto","No","12094","0","151382","4534","168010","Included"
"2025-09-04T01:46:16.248Z","pro-free-trial","auto","No","1781","0","643616","662","646059","Included"
"2025-09-04T01:45:20.062Z","pro-free-trial","auto","No","2715","0","525521","1747","529983","Included"
"2025-09-04T01:44:02.218Z","pro-free-trial","auto","No","4100","0","1014639","948","1019687","Included"
"2025-09-04T01:43:40.699Z","pro-free-trial","auto","No","583","0","198504","655","199742","Included"
"2025-09-04T01:32:24.145Z","pro-free-trial","auto","No","268676","0","435276","1215","705167","Included"
"2025-09-03T23:13:44.748Z","pro-free-trial","auto","No","9447","0","506296","1851","517594","Included"
"2025-09-03T23:12:29.932Z","pro-free-trial","auto","No","47255","0","422734","1024","471013","Included"
"2025-09-03T23:12:24.055Z","Errored, Not Charged","auto","No","96","0","49370","122","49588","Included"
"2025-09-03T23:11:12.973Z","Errored, Not Charged","auto","No","42023","0","7107","100","49230","Included"
"2025-09-03T23:11:09.792Z","Errored, Not Charged","auto","No","0","0","0","0","0","Included"
"2025-09-03T22:39:08.695Z","pro-free-trial","auto","No","24037","0","1668688","6530","1699255","Included"
"2025-09-03T22:20:54.542Z","pro-free-trial","auto","No","6407","0","282635","1637","290679","Included"
"2025-09-03T22:18:46.295Z","Errored, Not Charged","auto","No","13228","0","307762","1537","322527","Included"
"2025-09-03T22:16:17.684Z","pro-free-trial","auto","No","222","0","34823","176","35221","Included"
"2025-09-03T22:15:02.642Z","pro-free-trial","auto","No","244","0","34580","128","34952","Included"
"2025-09-03T22:14:59.800Z","pro-free-trial","auto","No","92","0","34489","153","34734","Included"
"2025-09-03T22:14:43.496Z","pro-free-trial","auto","No","229","0","68612","60","68901","Included"
"2025-09-03T22:13:10.599Z","pro-free-trial","auto","No","656","0","101483","130","102269","Included"
"2025-09-03T22:11:41.958Z","pro-free-trial","auto","No","4299","0","184367","1201","189867","Included"
"2025-09-03T22:09:43.212Z","Errored, Not Charged","auto","No","1268","7181","27453","1149","37051","Included"
"2025-09-03T22:06:00.894Z","Errored, Not Charged","auto","No","12230","0","215867","1232","229329","Included"
"2025-09-03T22:05:20.160Z","pro-free-trial","auto","No","8714","0","67658","770","77142","Included"
"2025-09-03T22:04:39.629Z","Errored, Not Charged","auto","No","1660","0","91224","487","93371","Included"
"2025-09-03T22:03:43.220Z","Errored, Not Charged","auto","No","2467","0","93230","718","96415","Included"
"2025-09-03T22:02:48.844Z","pro-free-trial","auto","No","1926","0","17262","242","19430","Included"
"2025-09-03T22:01:49.530Z","Errored, Not Charged","auto","No","0","0","0","0","0","Included"
"2025-09-03T21:59:03.358Z","Errored, Not Charged","auto","No","2061","0","503486","403","505950","Included"
"2025-09-03T21:58:28.525Z","pro-free-trial","auto","No","8539","0","483204","788","492531","Included"
"2025-09-03T21:55:39.224Z","pro-free-trial","auto","No","1495","0","369385","631","371511","Included"
"2025-09-03T21:54:13.484Z","pro-free-trial","auto","No","1525","0","421005","586","423116","Included"
"2025-09-03T21:53:07.052Z","pro-free-trial","auto","No","10719","0","396930","1654","409303","Included"
"2025-09-03T21:50:11.159Z","pro-free-trial","auto","No","1785","0","288317","523","290625","Included"
"2025-09-03T21:49:09.327Z","pro-free-trial","auto","No","6531","0","426200","885","433616","Included"
"2025-09-03T21:47:46.466Z","pro-free-trial","auto","No","661","0","80265","368","81294","Included"
"2025-09-03T21:46:50.224Z","pro-free-trial","auto","No","32856","0","358223","757","391836","Included"
"2025-09-03T21:37:10.410Z","pro-free-trial","auto","No","30140","0","405372","1681","437193","Included"
"2025-09-03T21:28:45.530Z","pro-free-trial","auto","No","281","0","42654","62","42997","Included"
"2025-09-03T21:25:21.730Z","pro-free-trial","auto","No","14135","5351","548991","8027","576504","Included"
"2025-09-03T21:25:15.033Z","pro-free-trial","auto","No","0","0","0","0","0","Included"
"2025-09-03T21:25:03.694Z","Errored, Not Charged","auto","No","0","0","0","0","0","Included"
"2025-09-03T21:05:25.479Z","pro-free-trial","auto","No","8543","20048","108256","2056","138903","Included"
"2025-09-03T21:03:32.687Z","pro-free-trial","auto","No","572","0","192189","248","193009","Included"
"2025-09-03T21:00:53.190Z","pro-free-trial","auto","No","6962","17001","748005","2199","774167","Included"
"2025-09-03T20:56:54.194Z","pro-free-trial","auto","No","1413","0","440726","648","442787","Included"
"2025-09-03T20:56:30.764Z","pro-free-trial","auto","No","9465","0","160484","335","170284","Included"
"2025-09-03T20:53:19.725Z","pro-free-trial","auto","No","9823","0","758585","1128","769536","Included"
"2025-09-03T20:52:35.619Z","pro-free-trial","auto","No","649","0","71498","903","73050","Included"
"2025-09-03T20:45:14.877Z","pro-free-trial","auto","No","36527","0","2161628","5010","2203165","Included"
"2025-09-03T20:37:36.385Z","pro-free-trial","auto","No","44337","0","633673","3657","681667","Included"
"2025-09-03T20:37:18.459Z","Errored, Not Charged","auto","No","0","0","0","0","0","Included"
"2025-09-03T20:36:55.650Z","pro-free-trial","auto","No","15445","0","7156","579","23180","Included"
"2025-09-03T20:12:40.710Z","Errored, Not Charged","auto","No","102212","70015","1920155","7046","2099428","Included"
"2025-09-03T20:10:11.320Z","Errored, Not Charged","auto","No","1180","0","234108","284","235572","Included"
"2025-09-03T20:06:19.061Z","pro-free-trial","auto","No","15866","0","3676910","4255","3697031","Included"
"2025-09-03T20:02:23.700Z","pro-free-trial","auto","No","16193","0","2045264","4878","2066335","Included"
"2025-09-03T19:59:09.901Z","Errored, Not Charged","auto","No","6323","0","646791","2884","655998","Included"
"2025-09-03T19:56:21.937Z","pro-free-trial","auto","No","8964","0","1843145","2061","1854170","Included"
"2025-09-03T19:55:21.293Z","pro-free-trial","auto","No","32150","0","1079095","4312","1115557","Included"
"2025-09-03T19:54:59.073Z","pro-free-trial","auto","No","80983","0","351254","494","432731","Included"
"2025-09-03T19:54:17.966Z","pro-free-trial","auto","No","6108","0","132193","943","139244","Included"
"2025-09-03T19:53:49.639Z","pro-free-trial","auto","No","61567","0","1130114","1969","1193650","Included"
"2025-09-03T19:53:38.189Z","Errored, Not Charged","auto","No","0","0","0","0","0","Included"
"2025-09-03T19:51:57.977Z","Errored, Not Charged","auto","No","3954","0","631574","505","636033","Included"
"2025-09-03T19:48:14.930Z","pro-free-trial","auto","No","1313","0","307739","460","309512","Included"
"2025-09-03T19:47:05.977Z","Errored, Not Charged","auto","No","3351","0","590018","2320","595689","Included"
"2025-09-03T19:46:41.011Z","pro-free-trial","auto","No","1814","0","287188","677","289679","Included"
"2025-09-03T19:44:23.773Z","pro-free-trial","auto","No","8621","0","1450084","2614","1461319","Included"
"2025-09-03T19:43:12.435Z","pro-free-trial","auto","No","2319","0","596488","742","599549","Included"
"2025-09-03T19:41:28.748Z","pro-free-trial","auto","No","655","0","167360","485","168500","Included"
"2025-09-03T19:40:52.177Z","pro-free-trial","auto","No","1668","0","164257","425","166350","Included"
"2025-09-03T19:39:20.347Z","pro-free-trial","auto","No","6487","0","701466","1763","709716","Included"
"2025-09-03T19:38:26.895Z","pro-free-trial","auto","No","68533","0","377324","901","446758","Included"
"2025-09-03T19:34:13.369Z","pro-free-trial","auto","No","3374","0","499644","941","503959","Included"
"2025-09-03T19:32:55.975Z","pro-free-trial","auto","No","4075","0","610129","1594","615798","Included"
"2025-09-03T19:32:26.776Z","pro-free-trial","auto","No","58953","0","138448","555","197956","Included"
"2025-09-03T19:27:02.031Z","pro-free-trial","claude-4-sonnet","No","10607","110","1257649","4279","1272645","Included"
"2025-09-03T19:25:44.427Z","pro-free-trial","claude-4-sonnet","No","2161","151","436046","898","439256","Included"
"2025-09-03T19:25:06.655Z","pro-free-trial","claude-4-sonnet","No","1045","396","141768","618","143827","Included"
"2025-09-03T19:22:26.192Z","Errored, Not Charged","claude-4-sonnet","No","13459","107","328702","961","343229","Included"
"2025-09-03T19:20:00.718Z","pro-free-trial","claude-4-sonnet","No","55085","130","515510","3704","574429","Included"
"2025-09-03T19:18:56.950Z","pro-free-trial","auto","No","122816","72802","73637","4036","273291","Included"
"2025-09-03T19:18:33.743Z","Errored, Not Charged","gpt-5","No","0","0","0","0","0","Included"
"2025-09-03T19:18:09.430Z","Errored, Not Charged","gpt-5-high","No","0","0","0","0","0","Included"
"2025-09-03T19:17:17.339Z","pro-free-trial","gpt-5-high","No","0","326","86656","1226","88208","Included"
"2025-09-03T19:16:27.917Z","Errored, Not Charged","gpt-5-high","No","0","0","0","0","0","Included"
"2025-09-03T19:15:18.893Z","pro-free-trial","gpt-5-high","No","0","2123","426112","1824","430059","Included"
"2025-09-03T19:11:14.443Z","pro-free-trial","gpt-5-high","No","0","928","168704","1625","171257","Included"
"2025-09-03T19:08:28.993Z","pro-free-trial","gpt-5-high","No","0","3495","326784","4766","335045","Included"
"2025-09-03T19:07:28.127Z","Errored, Not Charged","gpt-5-high","No","0","349","80384","1123","81856","Included"
"2025-09-03T19:07:21.119Z","pro-free-trial","claude-4-sonnet","No","3034","111","316719","1370","321234","Included"
"2025-09-03T19:06:49.424Z","pro-free-trial","claude-4-sonnet","No","429","31","43588","152","44200","Included"
"2025-09-03T19:04:15.872Z","pro-free-trial","claude-4-sonnet","No","3821","109","372954","1550","378434","Included"
"2025-09-03T19:03:37.899Z","pro-free-trial","gpt-5-high","No","0","754","79744","2034","82532","Included"
"2025-09-03T19:01:40.221Z","pro-free-trial","claude-4-sonnet","No","28568","36","358980","5299","392883","Included"
"2025-09-03T19:01:06.948Z","Errored, Not Charged","auto","No","0","0","0","0","0","Included"
"2025-09-03T18:56:33.025Z","pro-free-trial","gpt-5-high","No","0","128658","1380736","15350","1524744","Included"
"2025-09-03T18:54:44.859Z","pro-free-trial","auto","No","2971","0","1375241","1196","1379408","Included"
"2025-09-03T18:54:00.660Z","pro-free-trial","auto","No","398","0","158967","75","159440","Included"
"2025-09-03T18:52:25.090Z","Errored, Not Charged","auto","No","72247","0","1544871","1251","1618369","Included"
"2025-09-03T18:51:16.893Z","pro-free-trial","auto","No","2513","0","961344","914","964771","Included"
"2025-09-03T18:50:39.422Z","pro-free-trial","gpt-5-high","No","0","313","67456","650","68419","Included"
"2025-09-03T18:50:22.477Z","Errored, Not Charged","auto","No","2649","0","856992","605","860246","Included"
"2025-09-03T18:49:09.491Z","Errored, Not Charged","gpt-5-high","No","0","2651","198016","3839","204506","Included"
"2025-09-03T18:47:50.450Z","pro-free-trial","auto","No","8526","0","444009","1142","453677","Included"
"2025-09-03T18:44:59.837Z","pro-free-trial","gpt-5-high","No","0","13196","275328","8053","296577","Included"
"2025-09-03T18:44:42.222Z","pro-free-trial","auto","No","6666","0","1771014","1885","1779565","Included"
"2025-09-03T18:43:33.046Z","Errored, Not Charged","auto","No","4604","0","844801","1128","850533","Included"
"2025-09-03T18:38:17.551Z","pro-free-trial","auto","No","55926","0","69745","309","125980","Included"
"2025-09-03T18:37:12.216Z","pro-free-trial","gpt-5-high","No","0","153","52224","2759","55136","Included"
"2025-09-03T18:37:03.038Z","Errored, Not Charged","gpt-5-high","No","0","0","0","0","0","Included"
"2025-09-03T18:37:01.925Z","Aborted, Not Charged","gpt-5-high","No","0","0","0","0","0","Included"
"2025-09-03T18:36:16.149Z","Errored, Not Charged","gpt-5-high","No","0","2227","48896","1256","52379","Included"
"2025-09-03T18:34:51.721Z","pro-free-trial","gpt-5-high","No","0","1407","47616","2542","51565","Included"
"2025-09-03T18:31:27.743Z","pro-free-trial","auto","No","55037","0","1282751","3488","1341276","Included"
"2025-09-03T18:28:50.706Z","pro-free-trial","gpt-5-high","No","0","7846","127232","6551","141629","Included"
"2025-09-03T18:26:00.429Z","pro-free-trial","gpt-5-high","No","0","480","39552","2293","42325","Included"
"2025-09-03T18:23:44.893Z","pro-free-trial","gpt-5-high","No","0","1765","37888","1962","41615","Included"
"2025-09-03T18:21:25.383Z","pro-free-trial","gpt-5-high","No","0","627","75136","6007","81770","Included"
"2025-09-03T18:20:35.250Z","Errored, Not Charged","gpt-5-high","No","0","0","0","0","0","Included"
"2025-09-03T18:17:53.564Z","pro-free-trial","auto","No","130417","76640","75238","4648","286943","Included"
"2025-09-03T18:15:32.940Z","pro-free-trial","gpt-5-high","No","0","21290","47744","5737","74771","Included"
"2025-09-03T18:11:55.133Z","pro-free-trial","gemini-2.5-pro","No","0","6581","29028","731","36340","Included"
"2025-09-03T18:11:26.318Z","pro-free-trial","gemini-2.5-pro","No","0","1012","4051","50","5113","Included"
"2025-09-03T17:59:53.344Z","pro-free-trial","gpt-5-high","No","0","166704","1848704","7500","2022908","Included"
"2025-09-03T17:58:48.419Z","pro-free-trial","gemini-2.5-pro","No","0","26409","105638","170","132217","Included"
"2025-09-03T17:36:53.762Z","pro-free-trial","gemini-2.5-pro","No","0","7027","124536","474","132037","Included"
"2025-09-03T17:34:59.470Z","pro-free-trial","gemini-2.5-pro","No","0","25460","101841","451","127752","Included"
"2025-09-03T17:34:53.430Z","pro-free-trial","auto","No","185251","0","1206603","2132","1393986","Included"
"2025-09-03T17:18:34.252Z","pro-free-trial","gemini-2.5-pro","No","0","46817","187272","834","234923","Included"
"2025-09-03T17:15:17.692Z","pro-free-trial","gemini-2.5-pro","No","0","11982","104885","532","117399","Included"
"2025-09-03T17:13:08.024Z","pro-free-trial","gemini-2.5-pro","No","0","47508","785678","1199","834385","Included"
"2025-09-03T17:09:42.013Z","pro-free-trial","auto","No","14410","0","1756198","1844","1772452","Included"
"2025-09-03T17:08:12.067Z","pro-free-trial","auto","No","11658","0","69961","515","82134","Included"
"2025-09-03T17:02:56.944Z","pro-free-trial","gemini-2.5-pro","No","0","5748","22996","65","28809","Included"
"2025-09-03T16:57:41.940Z","pro-free-trial","auto","No","11170","0","1199604","7221","1217995","Included"
"2025-09-03T16:57:12.594Z","pro-free-trial","gemini-2.5-pro","No","0","47136","300102","1235","348473","Included"
"2025-09-03T16:53:35.286Z","Errored, Not Charged","auto","No","62592","0","3662629","8407","3733628","Included"
"2025-09-03T16:53:17.932Z","pro-free-trial","gpt-5-high","No","0","131879","2214144","62093","2408116","Included"
"2025-09-03T16:53:03.300Z","pro-free-trial","gemini-2.5-pro","No","0","25843","181668","1945","209456","Included"
"2025-09-03T16:44:11.155Z","pro-free-trial","auto","No","868","0","17440","98","18406","Included"
"2025-09-03T16:43:58.444Z","pro-free-trial","gpt-5-high","No","0","12047","6400","275","18722","Included"
"2025-09-03T16:39:29.014Z","pro-free-trial","gemini-2.5-pro","No","0","996","3985","748","5729","Included"
"2025-09-03T16:38:21.641Z","pro-free-trial","gemini-2.5-pro","No","0","2902","11615","402","14919","Included"
"2025-09-03T16:36:58.567Z","pro-free-trial","auto","No","132","0","50220","30","50382","Included"
"2025-09-03T16:35:10.635Z","pro-free-trial","auto","No","43160","0","7061","42","50263","Included"
"2025-09-03T16:33:31.118Z","pro-free-trial","claude-4-sonnet-thinking","No","59756","109","0","267","60132","Included"
"2025-09-03T16:13:28.957Z","pro-free-trial","gpt-5-high","No","0","17272","587904","12588","617764","Included"
"2025-09-03T16:03:44.107Z","pro-free-trial","gpt-5-high","No","0","27252","261376","21696","310324","Included"
"2025-09-03T15:54:32.855Z","pro-free-trial","gemini-2.5-pro","No","0","4235","18182","175","22592","Included"
"2025-09-03T15:22:48.967Z","pro-free-trial","auto","No","8146","0","798739","1497","808382","Included"
"2025-09-03T15:19:46.404Z","Errored, Not Charged","auto","No","20145","0","892469","2280","914894","Included"
"2025-09-03T15:18:06.323Z","pro-free-trial","auto","No","15400","0","166864","1132","183396","Included"
"2025-09-03T14:17:44.862Z","pro-free-trial","auto","No","6305","0","523468","2886","532659","Included"
"2025-09-03T14:17:01.908Z","pro-free-trial","auto","No","2208","0","284686","678","287572","Included"
"2025-09-03T14:12:25.676Z","pro-free-trial","auto","No","1685","0","137812","647","140144","Included"
"2025-09-03T14:10:26.054Z","pro-free-trial","auto","No","2697","0","200019","1589","204305","Included"
"2025-09-03T14:08:22.932Z","pro-free-trial","auto","No","58826","0","571316","2272","632414","Included"
"2025-09-03T13:52:05.331Z","pro-free-trial","auto","No","11051","0","443523","4981","459555","Included"
"2025-09-03T13:48:14.576Z","pro-free-trial","auto","No","3381","999","200057","2029","206466","Included"
"2025-09-03T13:46:26.926Z","Errored, Not Charged","auto","No","39964","0","492001","2133","534098","Included"
"2025-09-03T13:25:55.683Z","pro-free-trial","auto","No","5846","0","70503","2159","78508","Included"
"2025-09-03T13:25:08.547Z","pro-free-trial","auto","No","7535","0","62450","1086","71071","Included"
"2025-09-03T13:24:36.254Z","pro-free-trial","auto","No","4203","0","57948","1797","63948","Included"
"2025-09-03T13:21:58.601Z","pro-free-trial","auto","No","13164","0","163808","2573","179545","Included"
"2025-09-03T13:18:32.877Z","Errored, Not Charged","auto","No","7309","0","137424","662","145395","Included"
"2025-09-03T13:14:08.720Z","Errored, Not Charged","auto","No","29920","0","484037","1808","515765","Included"
"2025-09-03T13:11:07.542Z","Errored, Not Charged","auto","No","7958","0","36872","5092","49922","Included"
"2025-09-03T13:09:30.600Z","Errored, Not Charged","auto","No","0","0","0","0","0","Included"
"2025-09-03T13:08:09.615Z","pro-free-trial","auto","No","14734","0","421761","834","437329","Included"
"2025-09-03T13:07:22.632Z","Aborted, Not Charged","auto","No","0","0","0","0","0","Included"
"2025-09-03T13:06:05.987Z","Errored, Not Charged","auto","No","10911","0","423724","1214","435849","Included"
"2025-09-03T13:05:21.028Z","pro-free-trial","auto","No","3244","0","51442","344","55030","Included"
"2025-09-03T13:02:23.163Z","Errored, Not Charged","auto","No","0","0","0","0","0","Included"
"2025-09-03T13:01:11.299Z","Errored, Not Charged","auto","No","0","0","0","0","0","Included"
"2025-09-03T12:56:53.792Z","pro-free-trial","auto","No","40271","0","2547584","7338","2595193","Included"
"2025-09-03T12:52:03.429Z","pro-free-trial","auto","No","88033","0","1931278","4933","2024244","Included"
"2025-09-03T12:49:19.999Z","pro-free-trial","auto","No","38401","0","2510303","4523","2553227","Included"
"2025-09-03T12:45:38.670Z","pro-free-trial","auto","No","84532","106455","1957812","13123","2161922","Included"
"2025-09-03T12:38:28.882Z","pro-free-trial","auto","No","266586","42457","4033646","20090","4362779","Included"
"2025-09-03T12:37:13.986Z","Errored, Not Charged","auto","No","0","0","0","0","0","Included"
"2025-09-03T12:32:01.561Z","pro-free-trial","auto","No","260779","52","6402784","6801","6670416","Included"
"2025-09-03T12:25:53.133Z","Errored, Not Charged","auto","No","88541","0","2521695","4611","2614847","Included"
"2025-09-03T12:23:12.522Z","pro-free-trial","claude-4-sonnet","No","27968","212","1912344","3387","1943911","Included"
"2025-09-03T12:18:40.691Z","pro-free-trial","claude-4-sonnet","No","150835","1466","4482137","6604","4641042","Included"
"2025-09-03T12:13:00.534Z","pro-free-trial","claude-4-sonnet","No","113479","144","2622540","6930","2743093","Included"
"2025-09-03T12:12:49.689Z","Errored, Not Charged","gemini-2.5-pro","No","0","3911","15647","40","19598","Included"
"2025-09-03T12:07:15.040Z","pro-free-trial","gemini-2.5-pro","No","0","58173","332258","451","390882","Included"
"2025-09-03T12:02:23.293Z","pro-free-trial","gemini-2.5-pro","No","0","44036","644769","1054","689859","Included"
"2025-09-03T11:58:12.031Z","pro-free-trial","gemini-2.5-pro","No","0","69852","876809","1860","948521","Included"
"2025-09-03T11:46:12.763Z","pro-free-trial","gemini-2.5-pro","No","0","20600","82403","295","103298","Included"
"2025-09-03T11:45:32.940Z","pro-free-trial","gemini-2.5-pro","No","0","2125","44743","209","47077","Included"
"2025-09-03T11:45:29.213Z","pro-free-trial","gemini-2.5-pro","No","0","0","0","0","0","Included"
"2025-09-03T11:44:41.964Z","pro-free-trial","gemini-2.5-pro","No","0","4728","18915","801","24444","Included"
"2025-09-03T11:42:28.121Z","pro-free-trial","gemini-2.5-pro","No","0","5015","37506","4551","47072","Included"
"2025-09-03T11:41:34.285Z","Errored, Not Charged","gemini-2.5-pro","No","0","0","0","0","0","Included"
"2025-09-03T11:38:39.256Z","pro-free-trial","gemini-2.5-pro","No","0","5576","30506","457","36539","Included"
"2025-09-03T02:19:59.423Z","pro-free-trial","auto","No","2351","0","89294","596","92241","Included"
"2025-09-03T02:19:25.257Z","pro-free-trial","auto","No","3195","0","48171","362","51728","Included"
"2025-09-03T02:18:18.419Z","Errored, Not Charged","auto","No","6659","0","59468","392","66519","Included"
"2025-09-03T02:17:13.295Z","Errored, Not Charged","auto","No","0","0","0","0","0","Included"
"2025-09-03T02:16:06.468Z","pro-free-trial","auto","No","3389","0","770949","674","775012","Included"
"2025-09-03T02:13:31.684Z","pro-free-trial","auto","No","1826","0","538348","592","540766","Included"
"2025-09-03T02:08:08.798Z","pro-free-trial","auto","No","1518","0","423929","564","426011","Included"
"2025-09-03T02:06:48.043Z","pro-free-trial","auto","No","2030","0","313498","430","315958","Included"
"2025-09-03T02:04:50.574Z","pro-free-trial","auto","No","1501","0","622019","601","624121","Included"
"2025-09-03T02:04:30.801Z","Errored, Not Charged","auto","No","1183","0","512792","427","514402","Included"
"2025-09-03T02:03:27.148Z","pro-free-trial","auto","No","3065","0","602912","1077","607054","Included"
"2025-09-03T02:00:32.034Z","pro-free-trial","auto","No","4640","0","291521","283","296444","Included"
"2025-09-03T01:59:05.602Z","pro-free-trial","auto","No","3935","0","670995","1490","676420","Included"
"2025-09-03T01:55:29.371Z","Errored, Not Charged","auto","No","5112","0","818981","509","824602","Included"
"2025-09-03T01:53:49.184Z","pro-free-trial","auto","No","1038","0","353600","404","355042","Included"
"2025-09-03T01:53:27.483Z","Errored, Not Charged","auto","No","949","0","174828","88","175865","Included"
"2025-09-03T01:50:26.402Z","pro-free-trial","auto","No","4052","0","1020579","1246","1025877","Included"
"2025-09-03T01:48:38.445Z","pro-free-trial","auto","No","627","0","165163","175","165965","Included"
"2025-09-03T01:47:35.093Z","pro-free-trial","auto","No","6113","0","234791","651","241555","Included"
"2025-09-03T01:45:57.607Z","Errored, Not Charged","auto","No","68874","0","233781","382","303037","Included"
"2025-09-03T01:40:57.139Z","pro-free-trial","auto","No","2543","0","425981","973","429497","Included"
"2025-09-03T01:36:54.244Z","pro-free-trial","auto","No","4624","0","471374","1920","477918","Included"
"2025-09-03T01:34:39.147Z","Errored, Not Charged","auto","No","3225","0","380433","753","384411","Included"
"2025-09-03T01:33:45.307Z","pro-free-trial","auto","No","4107","0","711865","1556","717528","Included"
"2025-09-03T01:32:52.350Z","pro-free-trial","auto","No","26484","0","422759","1290","450533","Included"
"2025-09-03T01:30:24.069Z","Errored, Not Charged","auto","No","5791","0","123666","384","129841","Included"
"2025-09-03T01:29:25.193Z","Errored, Not Charged","auto","No","21467","0","267265","1335","290067","Included"
"2025-09-03T01:27:15.113Z","pro-free-trial","auto","No","8492","0","1280158","1376","1290026","Included"
"2025-09-03T01:26:22.279Z","Errored, Not Charged","auto","No","5883","0","1196743","1485","1204111","Included"
"2025-09-03T01:24:11.826Z","pro-free-trial","auto","No","17741","0","1468510","2898","1489149","Included"
"2025-09-03T01:23:22.703Z","pro-free-trial","auto","No","2637","0","622684","630","625951","Included"
"2025-09-03T01:22:13.903Z","pro-free-trial","auto","No","752","0","152192","268","153212","Included"
"2025-09-03T01:21:32.449Z","pro-free-trial","auto","No","5802","0","369410","893","376105","Included"
"2025-09-03T01:21:14.512Z","Errored, Not Charged","auto","No","0","0","0","0","0","Included"
"2025-09-03T01:16:42.967Z","Errored, Not Charged","auto","No","49343","0","124619","215","174177","Included"
"2025-09-03T01:11:08.344Z","pro-free-trial","auto","No","1390","0","180412","247","182049","Included"
"2025-09-03T01:09:43.511Z","pro-free-trial","auto","No","13991","0","1361661","1893","1377545","Included"
"2025-09-03T01:01:57.147Z","pro-free-trial","auto","No","820","0","75124","622","76566","Included"
"2025-09-03T01:00:47.977Z","pro-free-trial","auto","No","13731","0","269332","971","284034","Included"
"2025-09-03T00:57:27.043Z","pro-free-trial","auto","No","2995","0","417762","478","421235","Included"
"2025-09-03T00:57:09.078Z","Errored, Not Charged","auto","No","742","0","115762","123","116627","Included"
"2025-09-03T00:53:00.510Z","pro-free-trial","auto","No","13476","0","900188","5240","918904","Included"
"2025-09-03T00:51:34.103Z","pro-free-trial","auto","No","391","0","112566","123","113080","Included"
"2025-09-03T00:50:15.495Z","pro-free-trial","auto","No","36293","0","632256","6658","675207","Included"
"2025-09-03T00:47:42.903Z","pro-free-trial","auto","No","26713","0","565890","1159","593762","Included"
"2025-09-03T00:45:56.668Z","pro-free-trial","auto","No","3195","0","275470","1160","279825","Included"
"2025-09-03T00:45:41.396Z","Errored, Not Charged","auto","No","358","0","26075","86","26519","Included"
"2025-09-03T00:44:52.367Z","Errored, Not Charged","auto","No","694","0","75527","203","76424","Included"
"2025-09-03T00:43:39.909Z","Errored, Not Charged","auto","No","573","0","24332","0","24905","Included"
"2025-09-03T00:41:30.194Z","pro-free-trial","auto","No","3497","0","87558","848","91903","Included"
"2025-09-03T00:39:03.220Z","pro-free-trial","auto","No","13423","0","229124","912","243459","Included"
"2025-09-03T00:37:04.353Z","pro-free-trial","auto","No","1163","0","206854","53","208070","Included"
"2025-09-03T00:34:57.600Z","pro-free-trial","auto","No","18082","0","2200345","4562","2222989","Included"
"2025-09-03T00:30:41.906Z","pro-free-trial","auto","No","6653","0","904348","1772","912773","Included"
"2025-09-03T00:18:13.237Z","pro-free-trial","auto","No","72592","0","2406800","3544","2482936","Included"
"2025-09-03T00:17:21.715Z","pro-free-trial","auto","No","13284","0","133447","462","147193","Included"
"2025-09-03T00:14:19.072Z","pro-free-trial","auto","No","18925","0","1300931","1696","1321552","Included"
"2025-09-03T00:13:27.850Z","pro-free-trial","auto","No","5290","0","715825","850","721965","Included"
"2025-09-03T00:08:48.363Z","pro-free-trial","auto","No","79860","0","2677832","5888","2763580","Included"
"2025-09-02T23:59:05.224Z","pro-free-trial","auto","No","91745","98977","4245518","8213","4444453","Included"
"2025-09-02T23:57:38.375Z","pro-free-trial","auto","No","9001","0","1084113","862","1093976","Included"
"2025-09-02T23:54:02.450Z","pro-free-trial","auto","No","6433","0","1125610","1196","1133239","Included"
"2025-09-02T23:52:49.597Z","Errored, Not Charged","auto","No","6319","0","679983","496","686798","Included"
"2025-09-02T23:50:15.853Z","pro-free-trial","auto","No","9165","0","1818396","1704","1829265","Included"
"2025-09-02T23:45:56.493Z","pro-free-trial","auto","No","17406","0","1489663","2106","1509175","Included"
"2025-09-02T23:44:20.908Z","pro-free-trial","auto","No","17275","0","1248601","2286","1268162","Included"
"2025-09-02T23:41:52.925Z","pro-free-trial","auto","No","21413","0","732130","3268","756811","Included"
"2025-09-02T23:41:46.188Z","pro-free-trial","auto","No","0","0","0","0","0","Included"
"2025-09-02T23:40:37.520Z","pro-free-trial","auto","No","4081","0","138002","421","142504","Included"
"2025-09-02T23:39:25.571Z","Errored, Not Charged","auto","No","11185","105486","7116","4130","127917","Included"
"2025-09-02T23:37:47.538Z","pro-free-trial","gpt-5","No","0","7137","362880","1929","371946","Included"
"2025-09-02T23:36:17.791Z","pro-free-trial","gpt-5","No","0","12241","458112","2029","472382","Included"
"2025-09-02T23:35:03.097Z","pro-free-trial","gpt-5","No","0","3304","222976","1154","227434","Included"
"2025-09-02T23:33:03.330Z","pro-free-trial","gpt-5","No","0","1523","218496","1602","221621","Included"
"2025-09-02T23:31:45.361Z","pro-free-trial","gpt-5","No","0","1618","323712","722","326052","Included"
"2025-09-02T23:27:14.120Z","pro-free-trial","gpt-5","No","0","96978","631936","3331","732245","Included"
"2025-09-02T23:21:57.732Z","pro-free-trial","gpt-5","No","0","72117","93184","2374","167675","Included"
"2025-09-02T23:13:34.889Z","Errored, Not Charged","auto","No","50907","0","3016540","10506","3077953","Included"
"2025-09-02T23:11:21.751Z","pro-free-trial","auto","No","105464","0","1877637","2203","1985304","Included"
"2025-09-02T23:11:03.272Z","pro-free-trial","auto","No","1180","0","75221","689","77090","Included"
"2025-09-02T23:08:53.519Z","Errored, Not Charged","auto","No","130437","38332","2044522","4180","2217471","Included"
"2025-09-02T23:06:32.841Z","pro-free-trial","auto","No","5635","0","677084","1470","684189","Included"
"2025-09-02T23:05:12.064Z","Errored, Not Charged","auto","No","5485","0","317663","858","324006","Included"
"2025-09-02T23:03:46.795Z","pro-free-trial","auto","No","3663","0","328073","833","332569","Included"
"2025-09-02T23:02:49.274Z","pro-free-trial","auto","No","3945","0","302835","1246","308026","Included"
"2025-09-02T23:01:42.659Z","pro-free-trial","auto","No","6170","0","312442","3064","321676","Included"
"2025-09-02T23:00:13.935Z","pro-free-trial","auto","No","2135","0","7932","2118","12185","Included"
"2025-09-02T22:58:19.679Z","pro-free-trial","auto","No","5492","0","1373279","1450","1380221","Included"
"2025-09-02T22:54:11.281Z","pro-free-trial","auto","No","4852","0","1298185","2310","1305347","Included"
"2025-09-02T22:52:52.824Z","pro-free-trial","auto","No","5152","0","1317780","1739","1324671","Included"
"2025-09-02T22:50:36.567Z","pro-free-trial","auto","No","10720","0","989806","2124","1002650","Included"
"2025-09-02T22:46:37.267Z","pro-free-trial","auto","No","6276","0","1006535","3768","1016579","Included"
"2025-09-02T22:45:53.346Z","Errored, Not Charged","auto","No","3488","0","650161","1307","654956","Included"
"2025-09-02T22:42:59.246Z","pro-free-trial","auto","No","28015","0","692033","10977","731025","Included"
"2025-09-02T22:42:15.208Z","pro-free-trial","auto","No","5157","0","884267","2419","891843","Included"
"2025-09-02T22:41:01.117Z","Errored, Not Charged","auto","No","0","0","0","0","0","Included"
"2025-09-02T22:39:23.627Z","pro-free-trial","auto","No","5145","0","1064039","2059","1071243","Included"
"2025-09-02T22:38:14.664Z","pro-free-trial","auto","No","5464","0","629860","2181","637505","Included"
"2025-09-02T22:36:18.884Z","pro-free-trial","auto","No","7851","0","1116699","2279","1126829","Included"
"2025-09-02T22:32:37.133Z","pro-free-trial","auto","No","3988","0","444311","923","449222","Included"
"2025-09-02T22:31:44.665Z","pro-free-trial","auto","No","12625","0","29880","475","42980","Included"
"2025-09-02T22:30:55.259Z","pro-free-trial","auto","No","41245","0","84557","200","126002","Included"
"2025-09-02T22:28:01.675Z","pro-free-trial","auto","No","19995","0","1088470","3776","1112241","Included"
"2025-09-02T22:25:28.107Z","pro-free-trial","auto","No","7866","0","120140","1028","129034","Included"
"2025-09-02T22:24:54.580Z","pro-free-trial","auto","No","769","0","39893","280","40942","Included"
"2025-09-02T22:23:28.931Z","pro-free-trial","auto","No","5833","0","94769","778","101380","Included"
"2025-09-02T22:19:29.918Z","pro-free-trial","auto","No","13238","0","3241298","4790","3259326","Included"
"2025-09-02T22:15:33.248Z","pro-free-trial","auto","No","8179","0","3002924","2502","3013605","Included"
"2025-09-02T22:12:26.434Z","pro-free-trial","auto","No","13963","0","3096732","3304","3113999","Included"
"2025-09-02T22:08:49.018Z","pro-free-trial","auto","No","14452","0","3012702","4155","3031309","Included"
"2025-09-02T22:06:35.954Z","pro-free-trial","auto","No","9752","0","1490183","2222","1502157","Included"
"2025-09-02T22:03:36.908Z","pro-free-trial","auto","No","44204","0","1835339","2645","1882188","Included"
"2025-09-02T21:58:46.482Z","pro-free-trial","auto","No","64554","97588","3529619","24580","3716341","Included"
"2025-09-02T21:58:33.194Z","pro-free-trial","auto","No","9231","0","1400191","2231","1411653","Included"
"2025-09-02T21:54:58.579Z","pro-free-trial","auto","No","12093","0","30881","499","43473","Included"
"2025-09-02T21:47:51.282Z","pro-free-trial","auto","No","1334","0","202593","320","204247","Included"
"2025-09-02T21:47:10.393Z","pro-free-trial","auto","No","6790","0","382198","525","389513","Included"
"2025-09-02T21:41:40.705Z","pro-free-trial","auto","No","51290","0","1809490","8878","1869658","Included"
"2025-09-02T21:39:18.555Z","Errored, Not Charged","auto","No","21353","0","160947","1861","184161","Included"
"2025-09-02T21:33:16.912Z","pro-free-trial","auto","No","3730","23764","873120","1865","902479","Included"
"2025-09-02T21:31:32.532Z","pro-free-trial","auto","No","5491","0","1570157","1250","1576898","Included"
"2025-09-02T21:29:18.573Z","Errored, Not Charged","auto","No","3986","0","277398","148","281532","Included"
"2025-09-02T21:28:08.702Z","pro-free-trial","auto","No","4709","0","648106","2639","655454","Included"
"2025-09-02T21:25:53.308Z","pro-free-trial","auto","No","1360","19159","61469","1092","83080","Included"
"2025-09-02T21:23:02.670Z","pro-free-trial","auto","No","54368","0","708955","2201","765524","Included"
"2025-09-02T21:20:52.009Z","pro-free-trial","auto","No","1321","0","105903","127","107351","Included"
"2025-09-02T21:17:22.312Z","pro-free-trial","auto","No","16648","0","1084967","4228","1105843","Included"
"2025-09-02T21:15:43.626Z","Errored, Not Charged","auto","No","1673","0","277737","605","280015","Included"
"2025-09-02T21:13:32.134Z","Errored, Not Charged","auto","No","2357","0","326380","614","329351","Included"
"2025-09-02T21:12:09.358Z","Errored, Not Charged","auto","No","562","0","30877","184","31623","Included"
"2025-09-02T21:07:42.925Z","pro-free-trial","auto","No","7788","0","419169","2142","429099","Included"
"2025-09-02T21:06:35.898Z","pro-free-trial","auto","No","1623","0","66537","941","69101","Included"
"2025-09-02T21:01:10.159Z","pro-free-trial","auto","No","14391","0","339322","3044","356757","Included"
"2025-09-02T20:46:05.346Z","Errored, Not Charged","auto","No","1173","0","199766","131","201070","Included"
"2025-09-02T20:22:56.901Z","pro-free-trial","auto","No","92389","0","7801951","16722","7911062","Included"
"2025-09-02T20:15:08.467Z","pro-free-trial","auto","No","1648","0","303879","447","305974","Included"
"2025-09-02T20:09:46.834Z","pro-free-trial","auto","No","4667","0","392722","713","398102","Included"
"2025-09-02T20:09:37.447Z","pro-free-trial","auto","No","247","0","95926","287","96460","Included"
"2025-09-02T20:08:12.876Z","Errored, Not Charged","auto","No","2851","0","468997","313","472161","Included"
"2025-09-02T20:06:54.104Z","Errored, Not Charged","auto","No","85181","0","370502","275","455958","Included"
"2025-09-02T19:35:42.896Z","pro-free-trial","auto","No","69420","0","4487552","47296","4604268","Included"
"2025-09-02T19:33:27.915Z","pro-free-trial","auto","No","59416","0","342530","4791","406737","Included"
"2025-09-02T19:17:18.973Z","pro-free-trial","auto","No","42875","0","7114","62","50051","Included"
"2025-09-02T19:12:10.513Z","pro-free-trial","auto","No","40836","82514","112194","6455","241999","Included"
"2025-09-02T19:08:38.382Z","pro-free-trial","auto","No","3366","0","1216342","687","1220395","Included"
"2025-09-02T18:59:07.888Z","pro-free-trial","auto","No","0","0","0","0","0","Included"
"2025-09-02T18:58:45.422Z","pro-free-trial","auto","No","196","0","95909","361","96466","Included"
"2025-09-02T18:58:20.493Z","pro-free-trial","auto","No","282","0","95628","173","96083","Included"
"2025-09-02T18:55:28.740Z","Errored, Not Charged","auto","No","5342","0","90287","0","95629","Included"
"2025-09-02T18:52:35.682Z","pro-free-trial","auto","No","2707","0","1006067","812","1009586","Included"
"2025-09-02T18:51:46.467Z","Errored, Not Charged","auto","No","1808","0","535204","522","537534","Included"
"2025-09-02T18:50:48.881Z","pro-free-trial","auto","No","6486","0","344510","778","351774","Included"
"2025-09-02T18:48:28.743Z","pro-free-trial","auto","No","2225","0","743433","799","746457","Included"
"2025-09-02T18:48:01.345Z","Errored, Not Charged","auto","No","723","0","80872","63","81658","Included"
"2025-09-02T18:46:44.450Z","pro-free-trial","auto","No","621","0","80252","624","81497","Included"
"2025-09-02T18:46:10.648Z","pro-free-trial","auto","No","560","0","79693","529","80782","Included"
"2025-09-02T18:45:41.124Z","pro-free-trial","auto","No","3583","0","76111","465","80159","Included"
"2025-09-02T18:41:36.063Z","pro-free-trial","auto","No","3274","0","617508","705","621487","Included"
"2025-09-02T18:40:14.596Z","Errored, Not Charged","auto","No","4967","0","652679","1479","659125","Included"
"2025-09-02T18:38:56.727Z","pro-free-trial","auto","No","3669","0","346880","317","350866","Included"
"2025-09-02T18:37:07.211Z","pro-free-trial","auto","No","2999","0","405643","493","409135","Included"
"2025-09-02T18:36:15.741Z","Errored, Not Charged","auto","No","2803","0","386874","442","390119","Included"
"2025-09-02T18:35:53.572Z","pro-free-trial","auto","No","863","0","125768","379","127010","Included"
"2025-09-02T18:35:00.615Z","pro-free-trial","auto","No","2953","0","243738","694","247385","Included"
"2025-09-02T18:33:53.842Z","pro-free-trial","auto","No","1144","0","177012","450","178606","Included"
"2025-09-02T18:33:05.455Z","pro-free-trial","auto","No","1475","0","172999","622","175096","Included"
"2025-09-02T18:32:11.593Z","pro-free-trial","auto","No","2825","0","222904","386","226115","Included"
"2025-09-02T18:30:55.128Z","pro-free-trial","auto","No","922","0","161389","450","162761","Included"
"2025-09-02T18:28:01.126Z","Errored, Not Charged","auto","No","0","0","0","0","0","Included"
"2025-09-02T18:27:21.422Z","pro-free-trial","auto","No","1153","0","104494","487","106134","Included"
"2025-09-02T18:26:32.330Z","pro-free-trial","auto","No","3188","0","251113","2427","256728","Included"
"2025-09-02T18:26:17.062Z","Errored, Not Charged","auto","No","0","0","0","0","0","Included"
"2025-09-02T18:24:51.217Z","pro-free-trial","auto","No","6800","0","86708","2153","95661","Included"
"2025-09-02T18:24:12.667Z","pro-free-trial","auto","No","5489","0","81269","1691","88449","Included"
"2025-09-02T18:23:51.861Z","Errored, Not Charged","auto","No","357","0","38807","1578","40742","Included"
"2025-09-02T18:23:06.918Z","pro-free-trial","auto","No","4155","0","108624","1952","114731","Included"
"2025-09-02T18:22:20.339Z","pro-free-trial","auto","No","1778","0","67010","265","69053","Included"
"2025-09-02T18:21:37.598Z","pro-free-trial","auto","No","15439","0","146455","1208","163102","Included"
"2025-09-02T18:18:12.477Z","pro-free-trial","auto","No","14225","363","286382","5871","306841","Included"
"2025-09-02T18:16:17.657Z","pro-free-trial","auto","No","10258","0","111402","894","122554","Included"
"2025-09-02T18:15:25.437Z","Errored, Not Charged","auto","No","0","0","0","0","0","Included"
"2025-09-02T18:13:37.009Z","pro-free-trial","auto","No","12939","0","1248487","2899","1264325","Included"
"2025-09-02T18:10:20.360Z","pro-free-trial","auto","No","21881","0","2047947","8551","2078379","Included"
"2025-09-02T18:06:07.100Z","pro-free-trial","auto","No","29992","0","1497068","2173","1529233","Included"
"2025-09-02T18:03:39.782Z","pro-free-trial","auto","No","55727","0","1127234","3445","1186406","Included"
"2025-09-02T18:02:27.741Z","pro-free-trial","auto","No","6487","0","319141","425","326053","Included"
"2025-09-02T18:02:01.353Z","pro-free-trial","auto","No","5232","0","200006","373","205611","Included"
"2025-09-02T17:59:46.525Z","pro-free-trial","auto","No","10537","0","562173","2008","574718","Included"
"2025-09-02T17:58:44.754Z","pro-free-trial","auto","No","4570","0","342649","370","347589","Included"
"2025-09-02T17:58:07.046Z","pro-free-trial","auto","No","3711","0","486896","517","491124","Included"
"2025-09-02T17:57:29.762Z","pro-free-trial","auto","No","1641","0","77208","283","79132","Included"
"2025-09-02T17:57:18.526Z","pro-free-trial","auto","No","4211","0","72998","250","77459","Included"
"2025-09-02T17:55:27.757Z","Errored, Not Charged","auto","No","2227","89","161582","577","164475","Included"
"2025-09-02T17:54:07.468Z","pro-free-trial","auto","No","8917","0","353117","388","362422","Included"
"2025-09-02T17:54:00.227Z","pro-free-trial","auto","No","0","0","0","0","0","Included"
"2025-09-02T17:52:24.818Z","pro-free-trial","auto","No","7837","0","697462","498","705797","Included"
"2025-09-02T17:52:03.347Z","Errored, Not Charged","auto","No","4821","0","249066","261","254148","Included"
"2025-09-02T17:49:46.486Z","pro-free-trial","auto","No","9684","0","165804","277","175765","Included"
"2025-09-02T17:49:20.590Z","pro-free-trial","auto","No","10062","10509","43554","328","64453","Included"
"2025-09-02T17:48:31.041Z","pro-free-trial","auto","No","5848","0","189883","332","196063","Included"
"2025-09-02T17:46:57.812Z","pro-free-trial","auto","No","4277","7871","38985","452","51585","Included"
"2025-09-02T17:46:18.282Z","pro-free-trial","auto","No","1206","0","76668","146","78020","Included"
"2025-09-02T17:42:21.793Z","pro-free-trial","auto","No","10523","0","353115","6766","370404","Included"
"2025-09-02T17:42:00.542Z","Errored, Not Charged","auto","No","19479","0","40632","430","60541","Included"
"2025-09-02T17:40:26.864Z","Errored, Not Charged","auto","No","0","0","0","0","0","Included"
"2025-09-02T17:38:31.528Z","pro-free-trial","auto","No","9892","0","310144","470","320506","Included"
"2025-09-02T17:37:13.792Z","pro-free-trial","auto","No","9690","0","87248","467","97405","Included"
"2025-09-02T17:34:54.524Z","pro-free-trial","auto","No","11393","0","1274991","1782","1288166","Included"
"2025-09-02T17:29:17.036Z","pro-free-trial","auto","No","37936","0","4546188","8339","4592463","Included"
"2025-09-02T17:28:55.034Z","pro-free-trial","auto","No","45011","0","7323","1279","53613","Included"
"2025-09-02T17:27:30.263Z","Errored, Not Charged","auto","No","42566","81942","8918","13780","147206","Included"
"2025-09-02T17:26:15.189Z","Errored, Not Charged","auto","No","14886","0","1488574","1782","1505242","Included"
"2025-09-02T17:21:43.985Z","pro-free-trial","auto","No","13700","0","827317","1545","842562","Included"
"2025-09-02T17:18:25.660Z","pro-free-trial","auto","No","27319","0","2719345","4856","2751520","Included"
"2025-09-02T17:15:10.849Z","pro-free-trial","auto","No","61147","0","1435977","2491","1499615","Included"
"2025-09-02T17:00:47.116Z","Errored, Not Charged","auto","No","44688","0","1975076","11838","2031602","Included"
"2025-09-02T16:55:23.774Z","pro-free-trial","auto","No","6968","0","1076799","952","1084719","Included"
"2025-09-02T16:53:46.176Z","pro-free-trial","auto","No","85471","27638","655602","5203","773914","Included"
"2025-09-02T16:52:00.798Z","pro-free-trial","auto","No","10524","273715","72939","8845","366023","Included"
"2025-09-02T16:45:33.263Z","pro-free-trial","auto","No","77274","0","9001770","16533","9095577","Included"
"2025-09-02T16:45:13.512Z","Errored, Not Charged","auto","No","1851","0","168935","881","171667","Included"
"2025-09-02T16:43:53.959Z","Errored, Not Charged","auto","No","2548","0","215146","1415","219109","Included"
"2025-09-02T16:43:19.747Z","pro-free-trial","auto","No","21998","0","132886","1538","156422","Included"
"2025-09-02T16:42:42.658Z","pro-free-trial","auto","No","526","0","83424","157","84107","Included"
"2025-09-02T16:42:31.767Z","Errored, Not Charged","auto","No","1716","0","247711","427","249854","Included"
"2025-09-02T16:41:25.024Z","pro-free-trial","auto","No","490","0","81222","1064","82776","Included"
"2025-09-02T16:35:51.811Z","pro-free-trial","auto","No","29292","0","265082","678","295052","Included"
"2025-09-02T16:31:04.246Z","pro-free-trial","auto","No","44841","232","769228","4437","818738","Included"
"2025-09-02T16:15:12.404Z","Errored, Not Charged","auto","No","0","0","0","0","0","Included"
"2025-09-02T16:13:33.801Z","pro-free-trial","auto","No","103453","0","1424425","1114","1528992","Included"
"2025-09-02T16:12:23.992Z","pro-free-trial","auto","No","698","0","213740","348","214786","Included"
"2025-09-02T16:12:02.625Z","pro-free-trial","auto","No","7170","0","418218","452","425840","Included"
"2025-09-02T16:00:37.642Z","pro-free-trial","auto","No","200660","33349","7318946","28899","7581854","Included"
"2025-09-02T15:22:23.298Z","pro-free-trial","auto","No","37979","0","1823642","11061","1872682","Included"
"2025-09-02T15:18:03.826Z","pro-free-trial","auto","No","14802","0","905830","8218","928850","Included"
"2025-09-02T15:16:18.278Z","Errored, Not Charged","auto","No","22387","0","260919","2297","285603","Included"
"2025-09-02T15:15:04.369Z","pro-free-trial","auto","No","3889","0","233520","563","237972","Included"
"2025-09-02T15:14:03.421Z","pro-free-trial","auto","No","1953","0","298586","862","301401","Included"
"2025-09-02T15:13:54.414Z","Errored, Not Charged","auto","No","448","0","71968","106","72522","Included"
"2025-09-02T15:13:08.030Z","pro-free-trial","auto","No","748","0","141788","321","142857","Included"
"2025-09-02T15:12:56.299Z","pro-free-trial","auto","No","28007","0","7114","194","35315","Included"
"2025-09-02T15:11:32.132Z","pro-free-trial","auto","No","54585","59832","51623","5483","171523","Included"
"2025-09-02T15:09:33.507Z","pro-free-trial","auto","No","57057","0","291939","2265","351261","Included"
"2025-09-02T15:01:04.944Z","pro-free-trial","auto","No","82501","0","4175598","35040","4293139","Included"
"2025-09-02T14:56:48.697Z","pro-free-trial","auto","No","57609","0","3342627","18878","3419114","Included"
"2025-09-02T14:54:45.910Z","pro-free-trial","auto","No","1863","0","563989","589","566441","Included"
"2025-09-02T14:52:58.694Z","pro-free-trial","auto","No","4548","0","854871","1121","860540","Included"
"2025-09-02T14:49:10.822Z","pro-free-trial","auto","No","7042","0","1288218","922","1296182","Included"
"2025-09-02T14:47:24.586Z","pro-free-trial","auto","No","58846","0","734928","1122","794896","Included"
"2025-09-02T14:42:31.782Z","pro-free-trial","auto","No","45847","0","1641355","11522","1698724","Included"
"2025-09-02T14:32:36.375Z","pro-free-trial","auto","No","8749","0","760392","1042","770183","Included"
"2025-09-02T14:25:41.267Z","pro-free-trial","auto","No","40574","0","1377898","10962","1429434","Included"
"2025-09-02T14:24:11.673Z","Errored, Not Charged","auto","No","0","0","0","0","0","Included"
"2025-09-02T14:23:40.819Z","Errored, Not Charged","auto","No","0","0","0","0","0","Included"
"2025-09-02T14:21:02.106Z","Errored, Not Charged","auto","No","13223","0","3401933","3571","3418727","Included"
"2025-09-02T14:19:00.781Z","pro-free-trial","auto","No","22277","0","458869","622","481768","Included"
"2025-09-02T14:16:30.739Z","pro-free-trial","auto","No","7767","0","609830","1466","619063","Included"
"2025-09-02T14:14:20.293Z","pro-free-trial","auto","No","19017","0","4839275","6367","4864659","Included"
"2025-09-02T14:13:10.000Z","Errored, Not Charged","auto","No","66702","0","719399","2729","788830","Included"
"2025-09-02T14:11:55.505Z","pro-free-trial","auto","No","37678","0","815191","13111","865980","Included"
"2025-09-02T14:09:56.817Z","pro-free-trial","auto","No","8518","0","1279774","3057","1291349","Included"
"2025-09-02T14:08:50.071Z","pro-free-trial","auto","No","3791","0","285167","555","289513","Included"
"2025-09-02T14:03:31.512Z","pro-free-trial","auto","No","48305","175","3089724","14661","3152865","Included"
"2025-09-02T14:02:12.903Z","Errored, Not Charged","auto","No","0","0","0","0","0","Included"
"2025-09-02T13:57:13.628Z","pro-free-trial","auto","No","17031","0","1900299","7944","1925274","Included"
"2025-09-02T13:54:43.997Z","pro-free-trial","auto","No","6335","0","883941","2984","893260","Included"
"2025-09-02T13:53:19.731Z","Errored, Not Charged","auto","No","7080","1851","730429","4284","743644","Included"
"2025-09-02T13:49:51.183Z","pro-free-trial","auto","No","18449","0","662659","1388","682496","Included"
"2025-09-02T13:46:58.973Z","pro-free-trial","auto","No","11881","0","852561","2826","867268","Included"
"2025-09-02T13:43:39.786Z","pro-free-trial","auto","No","2498","0","173114","422","176034","Included"
"2025-09-02T13:41:34.910Z","pro-free-trial","auto","No","8814","1067","555225","1671","566777","Included"
"2025-09-02T13:36:02.911Z","pro-free-trial","auto","No","18395","0","930847","2570","951812","Included"
"2025-09-02T13:34:08.833Z","pro-free-trial","auto","No","27365","0","208394","930","236689","Included"
"2025-09-02T13:31:01.269Z","pro-free-trial","auto","No","945","238","60224","888","62295","Included"
"2025-09-02T13:24:15.081Z","pro-free-trial","auto","No","5817","0","138952","5265","150034","Included"
"2025-09-02T13:23:46.550Z","Errored, Not Charged","auto","No","0","0","0","0","0","Included"
"2025-09-02T13:18:42.337Z","pro-free-trial","auto","No","17595","0","169455","7686","194736","Included"
"2025-09-02T13:14:14.763Z","pro-free-trial","auto","No","916","0","132608","151","133675","Included"
"2025-09-02T13:09:05.199Z","pro-free-trial","auto","No","48868","0","906059","4030","958957","Included"
"2025-09-02T13:02:53.117Z","pro-free-trial","auto","No","23733","0","568606","10758","603097","Included"
"2025-09-02T12:56:20.107Z","Errored, Not Charged","auto","No","30662","0","7648","1269","39579","Included"
"2025-09-02T12:51:02.252Z","pro-free-trial","auto","No","109144","0","3059795","8509","3177448","Included"
"2025-09-02T12:17:59.649Z","pro-free-trial","auto","No","3858","0","251563","585","256006","Included"
"2025-09-02T12:16:54.206Z","pro-free-trial","auto","No","2507","0","494570","712","497789","Included"
"2025-09-02T12:11:54.666Z","pro-free-trial","auto","No","73694","0","2711541","12361","2797596","Included"
"2025-09-02T10:47:52.389Z","pro-free-trial","auto","No","44776","0","1909458","22205","1976439","Included"
"2025-09-02T10:41:17.751Z","Errored, Not Charged","auto","No","6376","0","244342","4437","255155","Included"
"2025-09-02T10:40:29.643Z","Errored, Not Charged","auto","No","3101","0","152572","1478","157151","Included"
"2025-09-02T10:38:43.890Z","Errored, Not Charged","auto","No","4131","0","56827","595","61553","Included"
"2025-09-02T10:32:29.889Z","Errored, Not Charged","auto","No","1240","0","373445","239","374924","Included"
"2025-09-02T10:30:28.837Z","pro-free-trial","auto","No","4390","0","791794","1293","797477","Included"
"2025-09-02T10:28:38.151Z","pro-free-trial","auto","No","2395","0","338591","450","341436","Included"
"2025-09-02T10:24:28.916Z","pro-free-trial","auto","No","23847","0","505759","1657","531263","Included"
"2025-09-02T10:23:20.066Z","pro-free-trial","auto","No","1902","0","62129","486","64517","Included"
"2025-09-02T10:19:04.519Z","Errored, Not Charged","auto","No","25691","0","1257782","5661","1289134","Included"
"2025-09-02T10:10:35.834Z","Errored, Not Charged","auto","No","29707","0","730935","21359","782001","Included"
"2025-09-01T19:09:18.618Z","pro-free-trial","auto","No","52392","0","413547","1004","466943","Included"
"2025-09-01T18:36:06.539Z","pro-free-trial","auto","No","4874","0","486891","1201","492966","Included"
"2025-09-01T18:35:52.198Z","pro-free-trial","auto","No","44570","0","6918","38","51526","Included"
"2025-09-01T18:03:45.421Z","pro-free-trial","auto","No","8657","0","528619","987","538263","Included"
"2025-09-01T18:02:11.532Z","pro-free-trial","auto","No","2725","0","199561","465","202751","Included"
"2025-09-01T18:02:03.691Z","Errored, Not Charged","auto","No","7","0","38586","91","38684","Included"
"2025-09-01T18:01:36.337Z","Errored, Not Charged","auto","No","577","0","38017","81","38675","Included"
"2025-09-01T17:46:38.630Z","pro-free-trial","auto","No","4793","0","284997","1122","290912","Included"
"2025-09-01T17:43:50.817Z","pro-free-trial","auto","No","3134","0","189505","596","193235","Included"
"2025-09-01T17:41:36.009Z","pro-free-trial","auto","No","7896","0","417237","1801","426934","Included"
"2025-09-01T17:39:31.776Z","pro-free-trial","auto","No","16711","101027","204444","6390","328572","Included"
"2025-09-01T17:37:55.233Z","pro-free-trial","auto","No","10032","95850","152590","3935","262407","Included"
"2025-09-01T17:37:44.770Z","Errored, Not Charged","auto","No","1733","0","218696","262","220691","Included"
"2025-09-01T17:37:37.823Z","Errored, Not Charged","auto","No","377","0","108521","86","108984","Included"
"2025-09-01T17:37:20.128Z","pro-free-trial","auto","No","362","0","108160","275","108797","Included"
"2025-09-01T17:30:18.757Z","pro-free-trial","auto","No","1722","0","535061","395","537178","Included"
"2025-09-01T17:28:33.652Z","pro-free-trial","auto","No","519","0","212191","334","213044","Included"
"2025-09-01T17:28:17.938Z","pro-free-trial","auto","No","618","0","210986","338","211942","Included"
"2025-09-01T17:27:26.186Z","pro-free-trial","auto","No","4000","0","722031","807","726838","Included"
"2025-09-01T17:27:08.251Z","pro-free-trial","auto","No","97496","0","3822","261","101579","Included"
"2025-09-01T17:01:41.016Z","pro-free-trial","auto","No","97135","57208","202233","1799","358375","Included"
"2025-09-01T14:37:57.287Z","pro-free-trial","auto","No","2619","0","383601","736","386956","Included"
"2025-09-01T14:33:35.929Z","pro-free-trial","auto","No","1449","0","471553","376","473378","Included"
"2025-09-01T14:31:07.909Z","pro-free-trial","auto","No","554","0","186804","210","187568","Included"
"2025-09-01T14:23:23.881Z","pro-free-trial","auto","No","5416","0","357487","3251","366154","Included"
"2025-09-01T14:21:38.326Z","pro-free-trial","auto","No","907","0","174607","137","175651","Included"
"2025-09-01T14:20:21.187Z","pro-free-trial","auto","No","1360","15074","261030","596","278060","Included"
"2025-09-01T14:19:33.661Z","pro-free-trial","auto","No","9225","1213","191690","1301","203429","Included"
"2025-09-01T14:19:05.166Z","Errored, Not Charged","auto","No","883","0","256022","429","257334","Included"
"2025-09-01T14:18:24.807Z","pro-free-trial","auto","No","6615","0","78429","275","85319","Included"
"2025-09-01T14:17:08.363Z","Errored, Not Charged","auto","No","1139","882","88381","4233","94635","Included"
"2025-09-01T14:14:28.045Z","pro-free-trial","auto","No","7995","0","578130","3337","589462","Included"
"2025-09-01T14:11:24.167Z","pro-free-trial","auto","No","11856","0","241343","4545","257744","Included"
"2025-09-01T14:09:37.944Z","pro-free-trial","auto","No","1924","0","224931","1211","228066","Included"
"2025-09-01T14:09:05.715Z","pro-free-trial","auto","No","2936","0","159430","1260","163626","Included"
"2025-09-01T14:08:04.925Z","pro-free-trial","auto","No","8848","0","187115","2227","198190","Included"
"2025-09-01T14:07:56.892Z","Errored, Not Charged","auto","No","0","0","0","0","0","Included"
"2025-09-01T14:07:48.687Z","Errored, Not Charged","auto","No","1811","0","83774","181","85766","Included"
"2025-09-01T14:05:29.337Z","pro-free-trial","auto","No","37785","0","141760","4569","184114","Included"
"2025-09-01T14:05:07.262Z","Errored, Not Charged","auto","No","0","0","0","0","0","Included"
"2025-09-01T14:04:02.054Z","Errored, Not Charged","auto","No","0","88601","0","4031","92632","Included"
"2025-09-01T13:59:44.761Z","pro-free-trial","auto","No","105845","0","758352","1279","865476","Included"
"2025-09-01T13:48:37.215Z","pro-free-trial","auto","No","19438","27098","1261608","8730","1316874","Included"
"2025-09-01T13:45:00.364Z","pro-free-trial","auto","No","1893","0","424941","297","427131","Included"
"2025-09-01T13:42:50.758Z","pro-free-trial","auto","No","9371","0","74767","478","84616","Included"
"2025-09-01T13:40:03.753Z","pro-free-trial","auto","No","81087","0","580780","753","662620","Included"
"2025-09-01T13:38:21.349Z","Errored, Not Charged","auto","No","3058","0","633545","2076","638679","Included"
"2025-09-01T13:37:04.367Z","Errored, Not Charged","auto","No","3211","0","303282","2006","308499","Included"
"2025-09-01T13:36:21.830Z","Errored, Not Charged","auto","No","3849","0","579192","624","583665","Included"
"2025-09-01T13:33:18.765Z","pro-free-trial","auto","No","10036","0","467658","4264","481958","Included"
"2025-09-01T13:31:33.827Z","pro-free-trial","auto","No","5468","0","408999","2362","416829","Included"
"2025-09-01T13:30:45.189Z","pro-free-trial","auto","No","2952","0","321952","737","325641","Included"
"2025-09-01T13:30:27.820Z","pro-free-trial","auto","No","453","0","51745","344","52542","Included"
"2025-09-01T13:29:42.065Z","pro-free-trial","auto","No","5782","0","289286","581","295649","Included"
"2025-09-01T13:28:14.400Z","pro-free-trial","auto","No","682","0","91020","157","91859","Included"
"2025-09-01T13:26:42.340Z","pro-free-trial","auto","No","5337","0","428307","1394","435038","Included"
"2025-09-01T13:24:33.084Z","pro-free-trial","auto","No","16373","0","285933","2304","304610","Included"
"2025-09-01T13:19:20.285Z","pro-free-trial","auto","No","11177","0","454132","2431","467740","Included"
"2025-09-01T13:19:16.633Z","Errored, Not Charged","auto","No","18577","0","3822","83","22482","Included"
"2025-09-01T12:50:22.327Z","pro-free-trial","auto","No","2147","0","79894","192","82233","Included"
"2025-09-01T12:46:12.894Z","pro-free-trial","auto","No","1986","0","90124","382","92492","Included"
"2025-09-01T12:44:54.679Z","pro-free-trial","auto","No","2363","221","69726","2055","74365","Included"
"2025-09-01T12:43:39.024Z","pro-free-trial","auto","No","1840","0","68485","435","70760","Included"
"2025-09-01T12:42:38.407Z","pro-free-trial","auto","No","3334","0","67481","1284","72099","Included"
"2025-09-01T12:40:10.577Z","pro-free-trial","auto","No","5811","0","70776","992","77579","Included"
"2025-09-01T12:39:25.308Z","Errored, Not Charged","auto","No","0","0","0","0","0","Included"
"2025-09-01T10:41:25.502Z","pro-free-trial","auto","No","92255","0","188315","114","280684","Included"
"2025-09-01T10:39:19.994Z","pro-free-trial","auto","No","12937","0","840108","4674","857719","Included"
"2025-09-01T10:36:47.197Z","pro-free-trial","auto","No","10282","0","643514","5637","659433","Included"
"2025-09-01T10:36:05.914Z","pro-free-trial","auto","No","64160","0","125798","469","190427","Included"
"2025-09-01T10:25:29.447Z","pro-free-trial","auto","No","3551","0","327551","490","331592","Included"
"2025-09-01T10:24:27.134Z","pro-free-trial","auto","No","48738","0","263130","503","312371","Included"
"2025-09-01T10:23:44.893Z","pro-free-trial","auto","No","15997","92916","5009","6013","119935","Included"
"2025-09-01T10:22:56.813Z","pro-free-trial","auto","No","11770","0","531730","913","544413","Included"
"2025-09-01T10:19:20.287Z","pro-free-trial","auto","No","2334","0","498957","447","501738","Included"
"2025-09-01T10:18:53.443Z","Errored, Not Charged","auto","No","3398","0","577777","626","581801","Included"
"2025-09-01T10:15:59.998Z","pro-free-trial","auto","No","295","0","94774","146","95215","Included"
"2025-09-01T10:14:04.889Z","pro-free-trial","auto","No","90953","0","3822","198","94973","Included"
"2025-09-01T09:50:53.182Z","pro-free-trial","auto","No","2103","0","464676","387","467166","Included"
"2025-09-01T09:50:30.602Z","pro-free-trial","auto","No","1152","0","182672","497","184321","Included"
"2025-09-01T09:49:54.499Z","pro-free-trial","auto","No","1216","0","180353","528","182097","Included"
"2025-09-01T09:49:36.028Z","pro-free-trial","auto","No","1149","0","178051","631","179831","Included"
"2025-09-01T09:48:52.579Z","pro-free-trial","auto","No","3180","0","347253","1154","351587","Included"
"2025-09-01T09:48:20.668Z","pro-free-trial","auto","No","1053","0","169467","646","171166","Included"
"2025-09-01T09:48:06.613Z","pro-free-trial","auto","No","673","0","168163","300","169136","Included"
"2025-09-01T09:47:54.579Z","pro-free-trial","auto","No","738","0","166782","307","167827","Included"
"2025-09-01T09:46:59.682Z","pro-free-trial","auto","No","3007","0","243413","1650","248070","Included"
"2025-09-01T09:46:03.667Z","pro-free-trial","auto","No","2638","0","234237","1409","238284","Included"
"2025-09-01T09:45:28.375Z","pro-free-trial","auto","No","1342","0","229876","621","231839","Included"
"2025-09-01T09:44:48.132Z","pro-free-trial","auto","No","3089","0","296803","1284","301176","Included"
"2025-09-01T09:44:26.303Z","pro-free-trial","auto","No","646","0","145262","244","146152","Included"
"2025-09-01T09:43:24.972Z","pro-free-trial","auto","No","1397","0","214724","365","216486","Included"
"2025-09-01T09:42:53.759Z","pro-free-trial","auto","No","2239","0","278630","830","281699","Included"
"2025-09-01T09:42:21.967Z","pro-free-trial","auto","No","3394","0","401417","858","405669","Included"
"2025-09-01T09:41:54.259Z","pro-free-trial","auto","No","2100","0","192743","640","195483","Included"
"2025-09-01T09:41:36.850Z","pro-free-trial","auto","No","1097","0","126455","441","127993","Included"
"2025-09-01T09:41:27.235Z","Errored, Not Charged","auto","No","59176","0","3822","86","63084","Included"
"2025-09-01T09:41:07.134Z","pro-free-trial","auto","No","508","0","124824","143","125475","Included"
"2025-09-01T09:40:55.435Z","Errored, Not Charged","auto","No","299","0","61646","155","62100","Included"
"2025-09-01T09:40:31.680Z","pro-free-trial","auto","No","2896","0","299518","705","303119","Included"
"2025-09-01T09:40:05.013Z","pro-free-trial","auto","No","1356","0","231087","692","233135","Included"
"2025-09-01T09:39:20.476Z","Errored, Not Charged","auto","No","291","0","57169","128","57588","Included"
"2025-09-01T09:38:56.344Z","pro-free-trial","auto","No","1260","0","225220","544","227024","Included"
"2025-09-01T09:38:31.226Z","pro-free-trial","auto","No","603","14670","55311","596","71180","Included"
"2025-09-01T09:38:10.861Z","pro-free-trial","auto","No","1555","0","107791","180","109526","Included"
"2025-09-01T09:37:48.391Z","pro-free-trial","auto","No","3576","0","152360","1172","157108","Included"
"2025-09-01T09:37:23.464Z","pro-free-trial","auto","No","3668","0","141647","1141","146456","Included"
"2025-09-01T09:37:01.203Z","pro-free-trial","auto","No","2599","0","133722","1386","137707","Included"
"2025-09-01T09:36:35.611Z","pro-free-trial","auto","No","1844","0","128055","1187","131086","Included"
"2025-09-01T09:36:00.700Z","pro-free-trial","auto","No","2043","0","122199","1193","125435","Included"
"2025-09-01T09:35:12.837Z","pro-free-trial","auto","No","16616","0","99238","1699","117553","Included"
"2025-09-01T09:31:01.138Z","pro-free-trial","auto","No","41033","2676","124729","14120","182558","Included"
"2025-09-01T09:30:52.342Z","Errored, Not Charged","auto","No","0","0","0","0","0","Included"
"2025-09-01T09:30:14.821Z","pro-free-trial","auto","No","3255","0","84741","1444","89440","Included"
"2025-09-01T09:29:44.509Z","pro-free-trial","auto","No","1992","0","74393","813","77198","Included"
"2025-09-01T09:29:33.049Z","Errored, Not Charged","auto","No","464","0","34012","121","34597","Included"
"2025-09-01T09:28:44.054Z","Errored, Not Charged","auto","No","0","0","0","0","0","Included"
"2025-09-01T09:28:27.141Z","pro-free-trial","auto","No","1780","0","62021","580","64381","Included"
"2025-09-01T09:27:57.647Z","Errored, Not Charged","auto","No","1012","0","4107","84","5203","Included"
"2025-09-01T09:27:25.540Z","Errored, Not Charged","auto","No","5058","85348","30537","3178","124121","Included"
"2025-09-01T09:26:34.855Z","pro-free-trial","auto","No","701","0","214657","362","215720","Included"
"2025-09-01T09:26:05.425Z","pro-free-trial","auto","No","622","0","213416","206","214244","Included"
"2025-09-01T09:25:29.834Z","pro-free-trial","auto","No","722","0","212141","143","213006","Included"
"2025-09-01T09:24:17.745Z","pro-free-trial","auto","No","1348","0","314709","796","316853","Included"
"2025-09-01T09:23:48.931Z","pro-free-trial","auto","No","737","0","207928","210","208875","Included"
"2025-09-01T09:22:24.781Z","pro-free-trial","auto","No","1218","0","308971","441","310630","Included"
"2025-09-01T09:21:06.000Z","pro-free-trial","auto","No","1345","0","304617","702","306664","Included"
"2025-09-01T09:20:48.461Z","pro-free-trial","auto","No","607","0","201500","192","202299","Included"
"2025-09-01T09:19:46.281Z","pro-free-trial","auto","No","539","0","200406","124","201069","Included"
"2025-09-01T09:19:28.871Z","pro-free-trial","auto","No","631","0","199146","252","200029","Included"
"2025-09-01T09:18:13.620Z","pro-free-trial","auto","No","655","0","197839","242","198736","Included"
"2025-09-01T09:17:32.494Z","pro-free-trial","auto","No","739","0","196510","207","197456","Included"
"2025-09-01T09:17:01.247Z","pro-free-trial","auto","No","1109","0","291921","508","293538","Included"
"2025-09-01T09:16:46.835Z","pro-free-trial","auto","No","752","0","192758","339","193849","Included"
"2025-09-01T09:16:06.013Z","pro-free-trial","auto","No","596","0","191445","341","192382","Included"
"2025-09-01T09:15:44.358Z","pro-free-trial","auto","No","557","0","190336","202","191095","Included"
"2025-09-01T09:15:24.108Z","pro-free-trial","auto","No","726","0","189053","195","189974","Included"
"2025-09-01T09:14:57.697Z","pro-free-trial","auto","No","994","0","280814","533","282341","Included"
"2025-09-01T09:14:35.996Z","pro-free-trial","auto","No","683","0","185638","204","186525","Included"
"2025-09-01T09:14:18.627Z","pro-free-trial","auto","No","850","0","184061","332","185243","Included"
"2025-09-01T09:13:43.222Z","pro-free-trial","auto","No","1612","0","272245","858","274715","Included"
"2025-09-01T09:12:44.246Z","pro-free-trial","auto","No","1362","0","267717","708","269787","Included"
"2025-09-01T09:11:51.518Z","pro-free-trial","auto","No","1622","0","439475","486","441583","Included"
"2025-09-01T09:11:09.376Z","pro-free-trial","auto","No","1210","0","259422","433","261065","Included"
"2025-09-01T09:10:18.159Z","pro-free-trial","auto","No","2145","0","168001","1351","171497","Included"
"2025-09-01T09:10:00.810Z","pro-free-trial","auto","No","561","0","166893","117","167571","Included"
"2025-09-01T09:09:47.983Z","pro-free-trial","auto","No","690","0","165590","201","166481","Included"
"2025-09-01T09:09:05.921Z","pro-free-trial","auto","No","716","0","164165","309","165190","Included"
"2025-09-01T09:08:47.124Z","pro-free-trial","auto","No","639","0","162827","279","163745","Included"
"2025-09-01T09:06:55.024Z","pro-free-trial","auto","No","799","0","161473","142","162414","Included"
"2025-09-01T09:06:11.615Z","pro-free-trial","auto","No","2089","0","475377","925","478391","Included"
"2025-09-01T09:05:55.426Z","pro-free-trial","auto","No","609","0","155838","212","156659","Included"
"2025-09-01T09:05:32.616Z","pro-free-trial","auto","No","916","0","154244","228","155388","Included"
"2025-09-01T09:04:41.329Z","pro-free-trial","auto","No","1512","0","227421","735","229668","Included"
"2025-09-01T09:03:39.636Z","pro-free-trial","auto","No","900","0","149365","396","150661","Included"
"2025-09-01T09:03:22.791Z","pro-free-trial","auto","No","3388","0","144853","612","148853","Included"
"2025-09-01T09:03:04.793Z","pro-free-trial","auto","No","2037","0","144101","445","146583","Included"
"2025-09-01T09:02:48.166Z","Errored, Not Charged","auto","No","1298","0","69974","818","72090","Included"
"2025-09-01T09:02:34.158Z","Errored, Not Charged","auto","No","148","0","69827","651","70626","Included"
"2025-09-01T09:01:56.036Z","pro-free-trial","auto","No","540","0","139663","166","140369","Included"
"2025-09-01T09:01:39.630Z","pro-free-trial","auto","No","549","0","138574","169","139292","Included"
"2025-09-01T09:01:27.801Z","pro-free-trial","auto","No","3523","0","134500","180","138203","Included"
"2025-09-01T09:00:45.592Z","pro-free-trial","auto","No","3521","0","198644","2157","204322","Included"
"2025-09-01T09:00:34.978Z","Errored, Not Charged","auto","No","224","0","64669","510","65403","Included"
"2025-09-01T09:00:19.136Z","pro-free-trial","auto","No","825","0","128173","187","129185","Included"
"2025-09-01T08:59:37.202Z","pro-free-trial","auto","No","1315","0","188637","766","190718","Included"
"2025-09-01T08:59:18.858Z","Errored, Not Charged","auto","No","343","0","62192","0","62535","Included"
"2025-09-01T08:58:51.445Z","pro-free-trial","auto","No","919","0","122952","429","124300","Included"
"2025-09-01T08:58:12.663Z","pro-free-trial","auto","No","2025","0","239621","920","242566","Included"
"2025-09-01T08:55:58.011Z","pro-free-trial","auto","No","664","0","117351","339","118354","Included"
"2025-09-01T08:55:45.741Z","pro-free-trial","auto","No","848","0","115818","263","116929","Included"
"2025-09-01T08:55:31.563Z","pro-free-trial","auto","No","888","0","114071","439","115398","Included"
"2025-09-01T08:54:58.351Z","pro-free-trial","auto","No","1365","0","111433","632","113430","Included"
"2025-09-01T08:54:37.029Z","pro-free-trial","auto","No","1722","0","108024","917","110663","Included"
"2025-09-01T08:54:21.847Z","pro-free-trial","auto","No","1301","0","105354","718","107373","Included"
"2025-09-01T08:53:28.405Z","pro-free-trial","auto","No","1064","0","103304","544","104912","Included"
"2025-09-01T08:52:22.516Z","pro-free-trial","auto","No","2798","0","147608","1353","151759","Included"
"2025-09-01T08:52:06.196Z","pro-free-trial","auto","No","926","0","95775","473","97174","Included"
"2025-09-01T08:50:52.961Z","pro-free-trial","auto","No","1357","0","140429","638","142424","Included"
"2025-09-01T08:49:56.715Z","pro-free-trial","auto","No","4669","0","262903","2017","269589","Included"
"2025-09-01T08:48:31.776Z","pro-free-trial","auto","No","4109","0","354127","1821","360057","Included"
"2025-09-01T08:48:14.469Z","pro-free-trial","auto","No","880","0","73873","434","75187","Included"
"2025-09-01T08:47:37.757Z","pro-free-trial","auto","No","1208","0","71314","788","73310","Included"
"2025-09-01T08:47:12.023Z","pro-free-trial","auto","No","1046","0","69278","500","70824","Included"
"2025-09-01T08:46:52.623Z","pro-free-trial","auto","No","2356","0","99087","952","102395","Included"
"2025-09-01T08:46:06.188Z","pro-free-trial","auto","No","743","0","64568","204","65515","Included"
"2025-09-01T08:45:40.334Z","Errored, Not Charged","auto","No","487","0","28164","2308","30959","Included"
"2025-09-01T08:45:08.446Z","pro-free-trial","auto","No","1410","0","54252","477","56139","Included"
"2025-09-01T08:44:04.338Z","pro-free-trial","auto","No","3742","0","198849","1452","204043","Included"
"2025-09-01T08:41:15.232Z","pro-free-trial","auto","No","19211","0","73010","7861","100082","Included"
"2025-09-01T04:23:02.085Z","pro-free-trial","auto","No","3752","0","103112","1249","108113","Included"
"2025-09-01T04:21:57.985Z","pro-free-trial","auto","No","3590","0","112087","1883","117560","Included"
"2025-09-01T04:21:00.731Z","pro-free-trial","auto","No","4723","0","91331","2089","98143","Included"
"2025-09-01T04:19:17.466Z","pro-free-trial","auto","No","12236","0","105848","4014","122098","Included"
"2025-09-01T04:18:16.104Z","Errored, Not Charged","auto","No","0","0","0","0","0","Included"
"2025-09-01T04:17:44.231Z","Errored, Not Charged","auto","No","0","0","0","0","0","Included"
"2025-09-01T04:16:55.930Z","pro-free-trial","auto","No","948","0","421282","392","422622","Included"
"2025-09-01T04:16:38.489Z","pro-free-trial","auto","No","636","0","208971","375","209982","Included"
"2025-09-01T04:16:15.407Z","pro-free-trial","auto","No","605","0","207747","399","208751","Included"
"2025-09-01T04:15:58.912Z","pro-free-trial","auto","No","657","0","206486","391","207534","Included"
"2025-09-01T04:15:43.041Z","pro-free-trial","auto","No","653","0","205195","466","206314","Included"
"2025-09-01T04:15:11.578Z","pro-free-trial","auto","No","738","0","203769","488","204995","Included"
"2025-09-01T04:13:56.235Z","pro-free-trial","auto","No","1133","0","404005","828","405966","Included"
"2025-09-01T04:13:17.671Z","pro-free-trial","auto","No","737","0","300371","450","301558","Included"
"2025-09-01T04:13:03.080Z","pro-free-trial","auto","No","619","0","198770","359","199748","Included"
"2025-09-01T04:12:45.966Z","pro-free-trial","auto","No","642","0","197427","445","198514","Included"
"2025-09-01T04:12:23.231Z","pro-free-trial","auto","No","836","0","294161","538","295535","Included"
"2025-09-01T04:12:08.222Z","pro-free-trial","auto","No","730","0","194375","435","195540","Included"
"2025-09-01T04:11:47.949Z","pro-free-trial","auto","No","697","0","192927","487","194111","Included"
"2025-09-01T04:11:14.751Z","pro-free-trial","auto","No","597","0","191749","366","192712","Included"
"2025-09-01T04:10:35.565Z","pro-free-trial","auto","No","2463","0","283856","549","286868","Included"
"2025-09-01T04:10:14.975Z","pro-free-trial","auto","No","557","0","188884","362","189803","Included"
"2025-09-01T04:09:54.075Z","pro-free-trial","auto","No","666","0","281695","388","282749","Included"
"2025-09-01T04:09:38.262Z","Errored, Not Charged","auto","No","529","0","186495","239","187263","Included"
"2025-09-01T04:09:22.216Z","Errored, Not Charged","auto","No","652","0","185319","241","186212","Included"
"2025-09-01T04:08:39.840Z","pro-free-trial","auto","No","1787","0","457099","781","459667","Included"
"2025-09-01T04:08:14.361Z","pro-free-trial","auto","No","754","0","180235","444","181433","Included"
"2025-09-01T04:07:23.242Z","pro-free-trial","auto","No","86097","0","272014","573","358684","Included"
"2025-09-01T03:47:41.793Z","pro-free-trial","auto","No","40203","2495","228564","857","272119","Included"
"2025-09-01T03:24:10.558Z","pro-free-trial","auto","No","405","0","88607","389","89401","Included"
"2025-09-01T03:08:40.450Z","pro-free-trial","auto","No","658","0","176207","490","177355","Included"
"2025-09-01T03:08:02.486Z","pro-free-trial","auto","No","665","0","174869","452","175986","Included"
"2025-09-01T03:07:47.033Z","pro-free-trial","auto","No","523","0","173838","265","174626","Included"
"2025-09-01T03:07:24.462Z","pro-free-trial","auto","No","614","0","172698","285","173597","Included"
"2025-09-01T03:05:37.955Z","pro-free-trial","auto","No","686","0","257010","439","258135","Included"
"2025-09-01T03:05:24.773Z","Errored, Not Charged","auto","No","350","0","84742","263","85355","Included"
"2025-09-01T03:04:53.252Z","pro-free-trial","auto","No","603","0","168717","284","169604","Included"
"2025-09-01T03:04:04.974Z","pro-free-trial","auto","No","1131","0","333983","822","335936","Included"
"2025-09-01T02:59:17.443Z","pro-free-trial","auto","No","1183","0","332853","818","334854","Included"
"2025-09-01T02:58:01.387Z","pro-free-trial","auto","No","573","0","164552","360","165485","Included"
"2025-09-01T02:57:38.725Z","pro-free-trial","auto","No","78312","0","85572","376","164260","Included"
"2025-09-01T02:55:54.340Z","pro-free-trial","auto","No","1136","0","241968","623","243727","Included"
"2025-09-01T02:55:39.337Z","pro-free-trial","auto","No","0","0","0","0","0","Included"
"2025-09-01T02:55:33.091Z","Errored, Not Charged","auto","No","427","0","79948","0","80375","Included"
"2025-09-01T02:55:23.095Z","Errored, Not Charged","auto","No","158","0","79791","171","80120","Included"
"2025-09-01T02:54:52.953Z","Errored, Not Charged","auto","No","371","0","80135","158","80664","Included"
"2025-09-01T02:54:08.519Z","pro-free-trial","auto","No","1003","0","158963","403","160369","Included"
"2025-09-01T02:53:42.281Z","pro-free-trial","auto","No","836","0","157124","720","158680","Included"
"2025-09-01T02:53:24.345Z","pro-free-trial","auto","No","705","0","155599","547","156851","Included"
"2025-09-01T02:38:15.410Z","pro-free-trial","auto","No","958","0","308261","382","309601","Included"
"2025-09-01T02:37:05.537Z","pro-free-trial","auto","No","4149","0","447615","2317","454081","Included"
"2025-09-01T02:36:24.742Z","pro-free-trial","auto","No","1754","0","141931","1043","144728","Included"
"2025-09-01T02:35:47.684Z","pro-free-trial","auto","No","1760","0","138452","896","141108","Included"
"2025-09-01T02:35:07.224Z","pro-free-trial","auto","No","1859","0","202907","1270","206036","Included"
"2025-09-01T02:34:58.499Z","pro-free-trial","auto","No","0","0","0","0","0","Included"
"2025-09-01T02:34:53.133Z","Errored, Not Charged","auto","No","0","0","0","0","0","Included"
"2025-09-01T02:34:28.549Z","Errored, Not Charged","auto","No","1400","0","129806","1094","132300","Included"
"2025-09-01T02:33:11.049Z","pro-free-trial","auto","No","6190","0","498673","2811","507674","Included"
"2025-09-01T02:31:49.071Z","pro-free-trial","auto","No","1063","0","231365","346","232774","Included"
"2025-09-01T02:31:00.649Z","pro-free-trial","auto","No","1804","0","224767","624","227195","Included"
"2025-09-01T02:30:16.694Z","pro-free-trial","auto","No","623","0","110480","301","111404","Included"
"2025-09-01T02:29:20.379Z","pro-free-trial","auto","No","2455","0","268225","1250","271930","Included"
"2025-09-01T02:28:46.713Z","pro-free-trial","auto","No","2918","0","204395","515","207828","Included"
"2025-09-01T02:28:14.453Z","pro-free-trial","auto","No","1246","736","136287","863","139132","Included"
"2025-09-01T02:27:45.315Z","pro-free-trial","auto","No","948","0","97321","642","98911","Included"
"2025-09-01T02:26:51.108Z","pro-free-trial","auto","No","2309","0","234120","837","237266","Included"
"2025-09-01T02:25:54.717Z","pro-free-trial","auto","No","508","0","91674","346","92528","Included"
"2025-09-01T02:24:41.615Z","pro-free-trial","auto","No","1639","0","178488","420","180547","Included"
"2025-09-01T02:24:10.613Z","pro-free-trial","auto","No","889","0","174312","593","175794","Included"
"2025-09-01T02:23:11.176Z","pro-free-trial","auto","No","741","0","128236","443","129420","Included"
"2025-09-01T02:22:39.824Z","pro-free-trial","auto","No","657","0","126106","491","127254","Included"
"2025-09-01T02:22:18.602Z","pro-free-trial","auto","No","500","0","82852","300","83652","Included"
"2025-09-01T02:21:43.954Z","pro-free-trial","auto","No","1357","0","202517","554","204428","Included"
"2025-09-01T02:20:49.397Z","pro-free-trial","auto","No","619","0","118578","453","119650","Included"
"2025-09-01T02:20:05.628Z","pro-free-trial","auto","No","893","0","157659","330","158882","Included"
"2025-09-01T02:19:21.665Z","pro-free-trial","auto","No","1284","0","268594","868","270746","Included"
"2025-09-01T02:18:07.402Z","pro-free-trial","auto","No","1134","0","36566","197","37897","Included"
"2025-09-01T02:17:25.937Z","Errored, Not Charged","auto","No","106","0","36139","171","36416","Included"
"2025-09-01T02:16:58.486Z","Errored, Not Charged","auto","No","351","0","35827","169","36347","Included"
"2025-09-01T02:16:27.625Z","pro-free-trial","auto","No","787","0","106069","544","107400","Included"
"2025-09-01T02:15:54.934Z","pro-free-trial","auto","No","657","0","69145","365","70167","Included"
"2025-09-01T02:15:00.806Z","pro-free-trial","auto","No","2040","0","199178","870","202088","Included"
"2025-09-01T02:14:25.457Z","pro-free-trial","auto","No","943","0","127167","710","128820","Included"
"2025-09-01T02:14:11.439Z","pro-free-trial","auto","No","834","0","61609","374","62817","Included"
"2025-09-01T02:13:39.949Z","pro-free-trial","auto","No","1459","0","148706","960","151125","Included"
"2025-09-01T02:12:49.023Z","pro-free-trial","auto","No","1480","0","113289","706","115475","Included"
"2025-09-01T02:12:10.830Z","pro-free-trial","auto","No","712","0","62041","455","63208","Included"
"2025-09-01T02:11:08.844Z","pro-free-trial","auto","No","2571","0","234752","1158","238481","Included"
"2025-09-01T02:10:05.330Z","pro-free-trial","auto","No","850","0","83169","563","84582","Included"
"2025-09-01T02:09:19.425Z","pro-free-trial","auto","No","596","0","54007","333","54936","Included"
"2025-09-01T02:08:55.452Z","pro-free-trial","auto","No","873","0","52519","339","53731","Included"
"2025-09-01T02:06:46.193Z","pro-free-trial","auto","No","2906","0","96946","1437","101289","Included"
"2025-09-01T01:57:07.779Z","pro-free-trial","auto","No","19253","0","3824","663","23740","Included"
"2025-08-31T21:41:25.186Z","pro-free-trial","auto","No","868","0","21657","371","22896","Included"
"2025-08-31T21:04:33.278Z","pro-free-trial","auto","No","17832","0","3826","735","22393","Included"
"2025-08-31T19:34:32.041Z","pro-free-trial","auto","No","1798","0","120690","1258","123746","Included"
"2025-08-31T19:33:45.049Z","pro-free-trial","auto","No","2625","0","160564","982","164171","Included"
"2025-08-31T19:32:46.774Z","pro-free-trial","auto","No","12950","0","66952","709","80611","Included"
"2025-08-31T19:29:14.787Z","pro-free-trial","auto","No","639","0","28509","420","29568","Included"
"2025-08-31T19:28:37.041Z","pro-free-trial","auto","No","2735","0","75409","485","78629","Included"
"2025-08-31T19:27:45.598Z","pro-free-trial","auto","No","424","0","22188","211","22823","Included"
"2025-08-31T19:27:34.898Z","pro-free-trial","auto","No","433","0","10546","140","11119","Included"
"2025-08-31T19:24:45.862Z","pro-free-trial","auto","No","6725","98658","3822","6526","115731","Included"
"2025-08-31T18:30:46.987Z","pro-free-trial","auto","No","103183","9548","3822","2187","118740","Included"
"2025-08-31T18:02:05.448Z","pro-free-trial","auto","No","287","0","106791","231","107309","Included"
"2025-08-31T17:44:18.993Z","pro-free-trial","auto","No","373","0","106419","174","106966","Included"
"2025-08-31T17:42:54.354Z","pro-free-trial","auto","No","1176","0","422806","450","424432","Included"
"2025-08-31T17:34:14.203Z","pro-free-trial","auto","No","1508","0","312653","583","314744","Included"
"2025-08-31T17:32:53.886Z","Errored, Not Charged","auto","No","982","0","309482","572","311036","Included"
"2025-08-31T17:31:07.051Z","pro-free-trial","auto","No","617","0","306894","586","308097","Included"
"2025-08-31T17:29:47.265Z","pro-free-trial","auto","No","1212","0","408550","567","410329","Included"
"2025-08-31T17:29:21.983Z","pro-free-trial","auto","No","333","0","101577","161","102071","Included"
"2025-08-31T17:29:12.001Z","Errored, Not Charged","auto","No","281","0","101297","143","101721","Included"
"2025-08-31T17:28:46.447Z","Errored, Not Charged","auto","No","2420","0","300995","339","303754","Included"
"2025-08-31T17:27:52.066Z","pro-free-trial","auto","No","2468","0","496896","1119","500483","Included"
"2025-08-31T17:27:46.133Z","Errored, Not Charged","auto","No","923","0","97182","119","98224","Included"
"2025-08-31T17:26:07.908Z","pro-free-trial","auto","No","35577","1066","66087","961","103691","Included"
"2025-08-31T17:23:41.568Z","pro-free-trial","auto","No","39300","36077","820761","2968","899106","Included"
"2025-08-31T17:22:43.854Z","pro-free-trial","auto","No","88808","0","370557","1317","460682","Included"
"2025-08-31T17:10:30.534Z","pro-free-trial","auto","No","1932","0","714506","1346","717784","Included"
"2025-08-31T17:08:35.618Z","pro-free-trial","auto","No","2252","0","786090","1459","789801","Included"
"2025-08-31T17:06:57.131Z","pro-free-trial","auto","No","5897","0","504431","2599","512927","Included"
"2025-08-31T16:59:20.729Z","pro-free-trial","auto","No","1010","0","318703","395","320108","Included"
"2025-08-31T16:58:29.484Z","pro-free-trial","auto","No","700","0","236528","484","237712","Included"
"2025-08-31T16:56:59.200Z","pro-free-trial","auto","No","616","0","156277","278","157171","Included"
"2025-08-31T16:56:40.778Z","pro-free-trial","auto","No","680","0","154830","478","155988","Included"
"2025-08-31T16:55:52.040Z","pro-free-trial","auto","No","1200","0","153182","261","154643","Included"
"2025-08-31T16:54:57.031Z","pro-free-trial","auto","No","978","0","228467","604","230049","Included"
"2025-08-31T16:54:09.744Z","Errored, Not Charged","auto","No","1545","0","374683","872","377100","Included"
"2025-08-31T16:52:56.612Z","pro-free-trial","auto","No","1535","0","219662","741","221938","Included"
"2025-08-31T16:50:25.651Z","pro-free-trial","auto","No","1515","0","215446","783","217744","Included"
"2025-08-31T16:44:23.517Z","pro-free-trial","auto","No","729","0","70602","252","71583","Included"
"2025-08-31T16:43:43.696Z","Errored, Not Charged","auto","No","3066","0","478760","952","482778","Included"
"2025-08-31T16:29:12.855Z","pro-free-trial","auto","No","923","0","267709","323","268955","Included"
"2025-08-31T16:28:42.292Z","pro-free-trial","auto","No","2298","0","327008","372","329678","Included"
"2025-08-31T16:26:58.554Z","pro-free-trial","auto","No","686","0","193310","508","194504","Included"
"2025-08-31T16:26:24.978Z","Errored, Not Charged","auto","No","1800","0","62108","244","64152","Included"
"2025-08-31T16:24:33.044Z","pro-free-trial","auto","No","5850","834","264228","1342","272254","Included"
"2025-08-31T16:23:54.227Z","pro-free-trial","auto","No","4231","0","180780","557","185568","Included"
"2025-08-31T16:21:57.958Z","Errored, Not Charged","auto","No","6630","0","885736","2132","894498","Included"
"2025-08-31T16:19:17.283Z","pro-free-trial","auto","No","18108","0","330602","1161","349871","Included"
"2025-08-31T16:15:04.505Z","pro-free-trial","auto","No","3499","0","93297","427","97223","Included"
"2025-08-31T16:14:57.696Z","pro-free-trial","auto","No","25659","0","3822","83","29564","Included"
"2025-08-31T16:13:30.017Z","pro-free-trial","auto","No","11065","9588","250603","1850","273106","Included"
"2025-08-31T16:07:33.998Z","pro-free-trial","auto","No","11922","96282","60115","4948","173267","Included"
"2025-08-31T16:03:54.410Z","pro-free-trial","auto","No","4380","0","856489","1474","862343","Included"
"2025-08-31T16:01:32.154Z","Errored, Not Charged","auto","No","2507","0","205061","750","208318","Included"
"2025-08-31T16:00:39.514Z","pro-free-trial","auto","No","3322","1012","516987","1250","522571","Included"
"2025-08-31T15:58:05.194Z","pro-free-trial","auto","No","10354","0","1293834","1625","1305813","Included"
"2025-08-31T15:54:03.442Z","pro-free-trial","auto","No","16571","0","311331","5606","333508","Included"
"2025-08-31T15:52:03.201Z","pro-free-trial","auto","No","3243","0","348373","610","352226","Included"
"2025-08-31T15:50:07.082Z","pro-free-trial","auto","No","27410","0","511138","921","539469","Included"
"2025-08-31T15:45:35.308Z","pro-free-trial","auto","No","20929","0","222325","9794","253048","Included"
"2025-08-31T15:44:56.670Z","Errored, Not Charged","auto","No","1","0","35963","2127","38091","Included"
"2025-08-31T15:43:32.904Z","Errored, Not Charged","auto","No","0","0","0","0","0","Included"
"2025-08-31T15:42:29.230Z","pro-free-trial","gpt-5","No","0","0","0","0","0","Included"
"2025-08-31T15:41:47.974Z","pro-free-trial","auto","No","1813","0","60490","1125","63428","Included"
"2025-08-31T15:37:02.707Z","pro-free-trial","auto","No","1245","0","28650","483","30378","Included"
"2025-08-31T15:36:34.294Z","pro-free-trial","auto","No","626","0","28025","1032","29683","Included"
"2025-08-31T15:34:35.414Z","pro-free-trial","auto","No","728","0","27298","410","28436","Included"
"2025-08-31T15:34:19.152Z","pro-free-trial","auto","No","819","0","26480","506","27805","Included"
"2025-08-31T15:33:57.589Z","pro-free-trial","auto","No","998","0","25483","604","27085","Included"
"2025-08-31T15:33:05.624Z","pro-free-trial","auto","No","1756","0","48229","859","50844","Included"
"2025-08-31T15:31:03.515Z","pro-free-trial","auto","No","1264","0","22466","554","24284","Included"
"2025-08-31T15:29:38.436Z","pro-free-trial","auto","No","20224","0","142967","1670","164861","Included"
"2025-08-31T15:26:04.771Z","pro-free-trial","auto","No","1715","0","18518","273","20506","Included"
"2025-08-31T15:25:28.484Z","pro-free-trial","auto","No","1846","0","28405","545","30796","Included"
"2025-08-31T15:24:14.805Z","Errored, Not Charged","auto","No","32","0","55823","0","55855","Included"
"2025-08-31T15:22:01.774Z","Errored, Not Charged","auto","No","0","0","0","0","0","Included"
"2025-08-31T15:21:44.426Z","Errored, Not Charged","auto","No","382","0","55358","0","55740","Included"
"2025-08-31T15:18:48.537Z","pro-free-trial","auto","No","3107","0","537354","759","541220","Included"
"2025-08-31T15:17:35.764Z","pro-free-trial","auto","No","1221","0","262689","426","264336","Included"
"2025-08-31T15:17:02.143Z","pro-free-trial","auto","No","1064","0","102121","313","103498","Included"
"2025-08-31T15:16:46.277Z","pro-free-trial","auto","No","430","0","101188","219","101837","Included"
"2025-08-31T15:16:18.512Z","Errored, Not Charged","auto","No","2401","0","195180","668","198249","Included"
"2025-08-31T15:14:58.686Z","pro-free-trial","auto","No","474","0","47440","316","48230","Included"
"2025-08-31T15:14:38.918Z","pro-free-trial","auto","No","43615","0","3826","345","47786","Included"
"2025-08-31T14:26:05.756Z","Errored, Not Charged","auto","No","43090","26514","28933","2509","101046","Included"
"2025-08-31T14:05:00.643Z","pro-free-trial","auto","No","639","0","44239","382","45260","Included"
"2025-08-31T14:03:11.604Z","Errored, Not Charged","auto","No","386","0","43854","220","44460","Included"
"2025-08-31T13:59:49.615Z","pro-free-trial","auto","No","5146","0","450363","1562","457071","Included"
"2025-08-31T13:55:45.043Z","pro-free-trial","auto","No","454","0","38266","355","39075","Included"
"2025-08-31T13:52:38.633Z","pro-free-trial","auto","No","417","0","37850","349","38616","Included"
"2025-08-31T13:52:04.446Z","pro-free-trial","auto","No","410","0","37441","327","38178","Included"
"2025-08-31T13:51:11.023Z","pro-free-trial","auto","No","468","0","36974","308","37750","Included"
"2025-08-31T13:50:54.538Z","pro-free-trial","auto","No","984","2346","35991","802","40123","Included"
"2025-08-31T13:50:29.469Z","pro-free-trial","auto","No","32170","3189","24071","1595","61025","Included"
"2025-08-31T13:39:35.309Z","pro-free-trial","auto","No","11784","2300","22334","827","37245","Included"
"2025-08-31T13:36:05.912Z","pro-free-trial","auto","No","10019","0","359353","1694","371066","Included"
"2025-08-31T13:35:15.391Z","Errored, Not Charged","auto","No","1144","0","44493","176","45813","Included"
"2025-08-31T13:34:49.079Z","Errored, Not Charged","auto","No","185","0","21885","58","22128","Included"
"2025-08-31T13:34:41.191Z","pro-free-trial","auto","No","294","0","21592","172","22058","Included"
"2025-08-31T13:34:20.133Z","pro-free-trial","auto","No","374","0","21219","277","21870","Included"
"2025-08-31T13:28:35.155Z","pro-free-trial","auto","No","371","0","20849","348","21568","Included"
"2025-08-31T13:28:08.893Z","pro-free-trial","auto","No","400","0","20450","351","21201","Included"
"2025-08-31T13:25:41.136Z","pro-free-trial","auto","No","439","0","20012","370","20821","Included"
"2025-08-31T13:23:36.205Z","pro-free-trial","auto","No","359","0","19654","412","20425","Included"
"2025-08-31T13:23:04.443Z","pro-free-trial","auto","No","428","0","19227","342","19997","Included"
"2025-08-31T13:22:04.030Z","pro-free-trial","auto","No","471","0","18757","409","19637","Included"
"2025-08-31T13:21:37.355Z","pro-free-trial","auto","No","311","0","18447","364","19122","Included"
"2025-08-31T13:10:18.817Z","pro-free-trial","auto","No","883","0","17565","289","18737","Included"
"2025-08-31T13:09:35.780Z","pro-free-trial","auto","No","904","15263","17135","759","34061","Included"
"2025-08-31T13:08:46.499Z","pro-free-trial","auto","No","369","0","16767","398","17534","Included"
"2025-08-31T13:03:38.640Z","pro-free-trial","auto","No","512","0","16256","353","17121","Included"
"2025-08-31T12:55:01.102Z","pro-free-trial","auto","No","101","0","16156","410","16667","Included"
"2025-08-31T12:54:39.724Z","pro-free-trial","auto","No","427","0","15730","86","16243","Included"
"2025-08-31T12:54:23.628Z","pro-free-trial","auto","No","394","0","15337","414","16145","Included"
"2025-08-31T12:53:58.207Z","pro-free-trial","auto","No","1205","12755","14133","790","28883","Included"
"2025-08-31T12:45:13.435Z","pro-free-trial","auto","No","10147","2878","230274","10534","253833","Included"
"2025-08-31T12:44:01.783Z","Errored, Not Charged","auto","No","0","570","2950","255","3775","Included"
"2025-08-31T12:42:28.271Z","pro-free-trial","auto","No","86298","0","93095","748","180141","Included"
"2025-08-31T12:35:40.578Z","pro-free-trial","auto","No","825","0","87646","712","89183","Included"
"2025-08-31T12:33:53.110Z","pro-free-trial","auto","No","570","0","87077","721","88368","Included"
"2025-08-31T12:33:06.761Z","pro-free-trial","auto","No","1161","0","259353","772","261286","Included"
"2025-08-31T12:27:45.644Z","pro-free-trial","auto","No","1527","0","255018","613","257158","Included"
"2025-08-31T12:24:47.085Z","pro-free-trial","auto","No","2133","0","416154","604","418891","Included"
"2025-08-31T12:18:10.349Z","pro-free-trial","auto","No","2218","0","486160","824","489202","Included"
"2025-08-31T12:16:40.492Z","pro-free-trial","auto","No","1636","0","316504","441","318581","Included"
"2025-08-31T12:15:43.245Z","pro-free-trial","auto","No","1702","0","153861","1032","156595","Included"
"2025-08-31T12:14:16.997Z","pro-free-trial","auto","No","3100","0","298797","1648","303545","Included"
"2025-08-31T12:13:37.873Z","pro-free-trial","auto","No","6738","0","139322","1214","147274","Included"
"2025-08-31T12:12:04.329Z","pro-free-trial","auto","No","5192","0","348742","1447","355381","Included"
"2025-08-31T12:09:38.030Z","Errored, Not Charged","auto","No","2818","0","197023","184","200025","Included"
"2025-08-31T12:08:00.253Z","pro-free-trial","auto","No","5112","0","430823","720","436655","Included"
"2025-08-31T11:54:18.797Z","pro-free-trial","auto","No","3298","0","314821","374","318493","Included"
"2025-08-31T11:38:19.184Z","pro-free-trial","auto","No","0","0","0","0","0","Included"
"2025-08-30T18:18:35.929Z","pro-free-trial","auto","No","975","0","42520","465","43960","Included"
"2025-08-30T18:16:51.749Z","pro-free-trial","auto","No","1390","0","125642","610","127642","Included"
"2025-08-30T18:15:43.977Z","pro-free-trial","auto","No","933","0","40201","378","41512","Included"
"2025-08-30T18:14:40.860Z","pro-free-trial","auto","No","2198","0","155793","879","158870","Included"
"2025-08-30T18:13:42.826Z","pro-free-trial","auto","No","1156","0","112050","572","113778","Included"
"2025-08-30T18:12:08.427Z","pro-free-trial","auto","No","2742","0","497147","1001","500890","Included"
"2025-08-30T18:11:19.464Z","pro-free-trial","auto","No","1100","0","66408","749","68257","Included"
"2025-08-30T18:10:36.290Z","pro-free-trial","auto","No","2160","0","126924","734","129818","Included"
"2025-08-30T18:09:14.462Z","pro-free-trial","auto","No","10261","0","73685","1667","85613","Included"
"2025-08-30T18:06:32.830Z","pro-free-trial","auto","No","16794","0","24354","153","41301","Included"
"2025-08-29T08:00:36.010Z","pro-free-trial","auto","No","17128","157467","210220","11623","396438","Included"
"2025-08-26T21:47:53.839Z","pro-free-trial","auto","No","3633","0","221163","1524","226320","Included"
"2025-08-26T21:47:25.282Z","pro-free-trial","auto","No","1578","0","263388","505","265471","Included"
"2025-08-26T21:46:19.949Z","pro-free-trial","auto","No","1526","0","205364","382","207272","Included"
"2025-08-26T21:45:54.863Z","pro-free-trial","auto","No","837","0","202885","364","204086","Included"
"2025-08-26T21:45:31.769Z","Errored, Not Charged","auto","No","1247","0","148094","297","149638","Included"
"2025-08-26T21:44:42.245Z","pro-free-trial","auto","No","1689","0","240580","410","242679","Included"
"2025-08-26T21:44:15.517Z","pro-free-trial","auto","No","1715","0","232482","611","234808","Included"
"2025-08-26T21:43:22.562Z","pro-free-trial","auto","No","1133","0","180394","540","182067","Included"
"2025-08-26T21:43:01.503Z","pro-free-trial","auto","No","274","0","44321","233","44828","Included"
"2025-08-26T21:41:39.059Z","pro-free-trial","auto","No","3366","0","213966","1359","218691","Included"
"2025-08-26T21:37:08.696Z","pro-free-trial","auto","No","281","0","40680","332","41293","Included"
"2025-08-26T21:36:25.652Z","pro-free-trial","auto","No","2560","0","157144","1317","161021","Included"
"2025-08-26T21:35:28.186Z","pro-free-trial","auto","No","2052","0","147995","1179","151226","Included"
"2025-08-26T21:35:09.502Z","Errored, Not Charged","auto","No","157","0","35053","626","35836","Included"
"2025-08-26T21:34:39.265Z","Errored, Not Charged","auto","No","2149","0","99911","936","102996","Included"
"2025-08-26T21:33:43.376Z","pro-free-trial","auto","No","2203","0","126419","1171","129793","Included"
"2025-08-26T21:32:52.456Z","pro-free-trial","auto","No","2171","0","147341","1062","150574","Included"
"2025-08-26T21:32:27.545Z","pro-free-trial","auto","No","12625","0","43279","646","56550","Included"
"2025-08-26T21:28:15.245Z","pro-free-trial","auto","No","22436","2299","162922","15088","202745","Included"
"2025-08-26T21:28:03.068Z","Errored, Not Charged","auto","No","0","0","0","0","0","Included"
"2025-08-26T21:26:37.096Z","Errored, Not Charged","auto","No","0","0","0","0","0","Included"
"2025-08-26T21:22:08.404Z","Errored, Not Charged","auto","No","25793","0","1117888","13687","1157368","Included"
"2025-08-26T21:04:12.489Z","pro-free-trial","auto","No","84531","0","812554","11063","908148","Included"
"2025-08-26T20:24:33.497Z","pro-free-trial","auto","No","64200","0","269375","2811","336386","Included"
"2025-08-26T19:51:31.372Z","pro-free-trial","auto","No","19151","0","486756","10353","516260","Included"
"2025-08-26T19:50:58.981Z","pro-free-trial","auto","No","371","0","86423","250","87044","Included"
"2025-08-26T19:50:37.918Z","Errored, Not Charged","auto","No","0","0","0","0","0","Included"
"2025-08-26T19:41:36.681Z","pro-free-trial","auto","No","46897","61946","522273","18017","649133","Included"
"2025-08-26T19:37:55.230Z","pro-free-trial","auto","No","102084","0","920556","7249","1029889","Included"
"2025-08-26T18:20:40.783Z","pro-free-trial","auto","No","11051","0","799948","6108","817107","Included"
"2025-08-26T18:20:10.451Z","pro-free-trial","auto","No","899","0","82476","879","84254","Included"
"2025-08-26T18:16:27.230Z","pro-free-trial","auto","No","922","0","81555","806","83283","Included"
"2025-08-26T18:15:19.621Z","pro-free-trial","auto","No","2173","0","79383","794","82350","Included"
"2025-08-26T18:10:51.020Z","pro-free-trial","auto","No","15439","0","722027","7894","745360","Included"
"2025-08-26T17:59:37.622Z","pro-free-trial","auto","No","9496","0","655792","6731","672019","Included"
"2025-08-26T17:53:44.096Z","pro-free-trial","auto","No","11811","0","729345","5630","746786","Included"
"2025-08-26T17:51:06.016Z","pro-free-trial","auto","No","3773","0","286272","631","290676","Included"
"2025-08-26T17:45:08.466Z","pro-free-trial","auto","No","8405","0","206971","5210","220586","Included"
"2025-08-26T17:36:29.755Z","pro-free-trial","auto","No","8706","0","176985","6272","191963","Included"
"2025-08-26T17:27:57.906Z","pro-free-trial","auto","No","11188","0","88209","5982","105379","Included"
"2025-08-26T17:25:44.063Z","pro-free-trial","auto","No","5186","0","61553","2347","69086","Included"
"2025-08-26T17:24:27.983Z","pro-free-trial","auto","No","1627","0","17371","923","19921","Included"
